ABACUS	frame with balls for calculating
ABASH	to make ashamed
ABATE	to lessen to subside
ABBESS	a female superior or governess of a nunnery
ABBEY	a monastery or society of people
ABBOT	the superior or head of an abbey or monastery
ABDOMEN	the belly/stomach
ABDUCT	to take away secretly by force
ABED	in bed
ABET	help/encourage smb (in doing wrong)
ABHOR	to hate to detest
ABIDE	be faithful to endure
ABJECT	to cast off or down, to abase
ABJURE	promise or swear to give up
ABORT	to miscarry, to bring forth something prematurely
ABOUND	to be plentiful, to be very prevalent, to overflow
ABRADE	to rub or wear away
ABRADED	rubbed off worn away by friction
ABRIDGE	to shorten in duration
ABSCESS	to form such a collection of pus
ABSCOND	to depart secretly
ABSENCE	a state of being absent
ABSOLVE	to set free from an obligation
ABSTAIN	refrain from (something)
ABUSIVE	treating badly or injuriously
ABUT	border on
ABYSMAL	bottomless extreme
ABYSS	an immeasurably deep gulf or great space
ACCEDE	(obsolete) to approach, to arrive, to come forward
ACCESS	to gain or obtain access to
ACCLAIM	applaud
ACCORD	to make to agree or correspond, to suit one thing to another
ACCOST	to approach and speak to boldly or aggressively
ACCOUNT	to compute, to count
ACCRUE	to happen or result as a natural growth, addition
ACCURSE	to devote to destruction
ACCUSE	to find fault with, to blame
ACERBIC	acid in temper, mood or tone
ACETATE	any salt or ester of acetic acid
ACETIC	of, pertaining to, or producing vinegar
ACME	the top or highest point, pinnacle, culmination
ACQUIRE	to get
ACQUIT	to declare or find not guilty, innocent
ACREAGE	size, as measured in acres
ACRID	sharp and harsh, or bitter and not to the taste, pungent
ACTUARY	registrar, clerk
ACUITY	sharpness or acuteness, as of a needle, wit, etc
ACUMEN	quickness of perception or discernment, penetration of mind
ACUTE	sharp
AD HOC	specifically for
ADAGE	an old saying, which has obtained credit by long use
ADAMANT	kind of stone inflexible
ADAPT	to make suitable, to make to correspond, to fit or suit
ADDLE	to make or become confused
ADDUCE	to cite (as proof)
ADEPT	well skilled, completely versed, thoroughly proficient
ADHERE	to stick fast or cleave, to become joined or united
ADIEU	a farewell, a goodbye, especially a fond farewell
ADJOURN	to postpone
ADJUDGE	to declare to be
ADJUNCT	attached to another in a dependent or subordinate position
ADO	to do, in doing, as, there is nothing ado
ADORN	add beauty decorate
ADROIT	dexterous
ADVENT	coming, arrival
ADVERSE	unfavorable, antagonistic in purpose or effect, hostile
ADVERT	to turn attention
AEGIS	the shield or breastplate of zeus or athena, protection
AERIAL	of, in, or from the air, atmospheric
AFFABLE	pleasant, easy to approach
AFFECT	to influence or alter
AFFIX	to attach
AFFLICT	to distress with mental/bodily pain
AFFRONT	to insult intentionally, especially openly
AFIRE	on fire
AFOOT	on foot
AFRESH	anew
AGGRESS	to set upon, to attack
AGHAST	terrified, struck with amazement
AGILE	active quick-moving
AGITATE	to move with a violent, irregular action
AGOG	eager/excited
AIL	trouble be ill
AILMENT	a disease, sickness
AKIN	related by blood, similar
ALBEIT	although, even if
ALBINO	a person, plant or animal with a deficiency in pigmentation
ALCHEMY	the search for a universal panacea (became chemistry)
ALCOVE	a small recessed area set off from a larger room
ALDER	belonging to the birch tree family
ALIAS	a false name used to conceal one's identity
ALIBI	an excuse, especially to avoid blame
ALIEN	a person who has been estranged or excluded
ALIMENT	that which nourishes, food
ALIMONY	a court-enforced allowance made to a former spouse
ALKALI	one of a class of caustic bases
ALLAY	to make quiet or put at rest, to pacify or appease
ALLEGE	to assert without proof
ALLOT	to distribute by lot
ALLOY	to debase by mixing with something inferior
ALLUDE	to refer casually or indirectly
ALLURE	to invite by something flattering or acceptable, to entice
ALLY	to unite, or form a connection between
ALMANAC	a book or table listing nautical, astronomical, etc. Events
ALOFT	in or into the air
ALOOF	reserved and remote, physically or emotionally distant
ALTAR	a table or similar flat-topped structure for religious rites
ALTER	to change the form or structure of
ALTO	a musical section higher than tenor and lower than soprano
AMALGAM	a combination of different things
AMASS	to collect into a mass or heap
AMATEUR	non-professional
AMATORY	of or relating to love
AMBLE	slow walk, stroll
AMBUSH	to act of lying in concealment as to attack by surprise
AMEND	to make better, to change
AMENITY	pleasantness
AMIABLE	friendly, sociable
AMISS	wrong, faulty, out of order, improper
AMITY	the cooperative and supportive relationship between people
AMNESTY	to grant a pardon (to a group)
AMORAL	being neither moral nor immoral
AMOROUS	inclined to love, having a propensity to love
AMOUR	a love affair
AMPERE	the base si unit of electrical current
AMPLE	large, great in size, extent, capacity, or bulk, spacious
AMPLY	abundantly
ANAGRAM	a word/phrase formed from another rearranging its letters
ANALOGY	similarity between like features of two things
ANALYST	someone who analyzes
ANALYZE	to subject to analysis
ANARCHY	a state of society without government or law
ANATOMY	the art of studying the different parts of an organized body
ANEMIA	a medical condition of too little hemoglobin
ANEW	over again
ANGELIC	belonging to, resembling, or proceeding from, angels
ANGUISH	severe suffering
ANGULAR	relating to an angle or angles, having an angle or angles
ANIMATE	to impart motion or the appearance of motion to
ANIMUS	the basic impulses and instincts which govern one's actions
ANNAL	occurring once a year
ANNEX	to add something to another, to incorporate into
ANNUITY	a specified income payable at stated intervals for period
ANNUL	to formally revoke the validity of
ANODE	electrode of an electrochemical cell where oxidation occurs
ANOINT	to rub or sprinkle on
ANOMALY	a deviation from a rule or from what is regarded as normal
ANTE	risks, stakes
ANTIC	a ludicrous or extravagant gesture
ANTIGEN	a toxin that induces an immune response in the body
ANTIQUE	of, or belonging to the past, not modern
ANTONYM	a word which has the opposite meaning of another
ANXIOUS	greatly concerned, respecting something future or unknown
APATHY	complete lack of emotion or motivation about something
APEX	the highest point of something
APIARY	a place where bees and their hives are kept
APLOMB	self-confidence
APOGEE	the point in orbit around Earth when the object is farthest
APOSTLE	a missionary, or leader of a religious mission
APPEASE	make quiet or calm
APPEND	to add as supplement or in addition
APPRISE	give notice to inform
APROPOS	appropriate to the situation apt
APT	well-suited quick-witted
AQUATIC	relating to water
AQUEOUS	consisting mostly of water
ARABLE	suitable for cultivation, such as by ploughing
ARBITER	a person empowered to make decisions
ARBOR	a shady sitting place, usually in a park or garden
ARCADE	a row of arches
ARCANE	known or understood by very few
ARCHAIC	of or characterized by antiquity
ARCHIVE	any extensive record or collection of data
ARDENT	intensely devoted, fervent, passionate
ARDOR	enthusiasm
ARDUOUS	difficult and tiring
ARGOT	jargon slang
ARIA	a musical piece written for a solo voice with accompaniment
ARID	extremely dry
ARMADA	a fleet of warships
ARMFUL	the amount an arm or arms can hold
ARMORY	a place where arms (weapons) are kept
AROMA	smell (usually in relation to food)
AROUSE	to evoke or awaken a feeling, emotion or response
ARRAIGN	to officially charge someone in a court of law
ARRANGE	to set up, to organize, especially in a positive manner
ARRANT	complete, total
ARREAR	work to be done, obligation
ARROYO	a small watercourse, usually dry except for heavy rains
ARSENAL	a collection or supply of weapons or munitions
ARTFUL	performed with, or characterized by, art or skill
ARTISAN	a worker in a skilled trade
ARTLESS	having or displaying no guile, cunning, or deceit
ASCEND	go or come up
ASCENT	the act of ascending a motion upwards
ASCETIC	a person who practices severe self-discipline
ASCRIBE	consider to be the origin of or belonging to
ASEPTIC	free of disease-causing microbes
ASEXUAL	having no distinct sex, having no interest in sex
ASHEN	of the pale gray color of ash
ASININE	foolish, unintelligent or silly
ASKANCE	turned to the side, especially of the eyes
ASKEW	turned or twisted to one side
ASPIRE	to hope or dream, especially towards a profession
ASSAIL	to make a concerted of violent attach on
ASSAY	to examine or analyze
ASSENT	to agree to, give approval to
ASSERT	to state a fact or belief confidently and forcefully
ASSESS	to determine, estimate or judge the value of, to evaluate
ASSET	something or someone of any value
ASSUAGE	make an unpleasant feeling less intense
ASTOUND	to overwhelm with amazement
ASTRAL	relating to or resembling the stars, starry
ASTUTE	clever quick at seeing to get an advantage
ASUNDER	apart, divided
ASYLUM	a place of safety
ATHEIST	of or relating to atheists or atheism, atheistic
ATHIRST	thirsty
ATHWART	across, crosswise
ATONE	to make reparation, compensation, or amends, for an offence
ATROPHY	to wither or waste away
ATTACHE	an official associated with an embassy
ATTAIN	to accomplish, to achieve
ATTEST	to affirm to be correct, true, or genuine
ATTUNE	bring into harmony
AUBURN	of a reddish-brown colour
AUDIBLE	capable of being heard
AUDIT	an official verification of records, especially financial
AUDITOR	a person appointed to examine accounting records
AUGMENT	to make bigger
AUGUR	to foretell events, to exhibit signs of future events
AUGURY	a divination based on the behaviour of animals
AUGUST	inspiring reverence or admiration, majestic
AURA	distinctive atmosphere or quality associated with something
AURAL	of or pertaining to the ear
AUREOLE	any encircling ring of light, halo
AURICLE	the outer ear or pinna
AURORA	an atmospheric phenomenon creating bands of light in the sky
AURORAL	pertaining to the dawn
AUSPICE	patronage or protection
AUSTERE	severe or strict in manner, attitude, or appearance
AUTOPSY	a post-mortem examination to discover the cause of death
AVARICE	greediness over wealth, covetousness
AVATAR	an incarnation or manifestation of a person or idea
AVENGE	to vindicate by inflicting pain or evil on a wrongdoer
AVER	affirm assert prove justify
AVERSE	to turn away
AVERT	to turn aside or away
AVIARY	an enclosure for keeping birds confined
AVID	eager greedy
AVIDITY	greediness, strong appetite
AVOW	admit. Declare openly
AWAKEN	to cause to become awake
AWE	to inspire fear and reverence
AWRY	crooked, distorted, out of place
AXIOM	a self-evident truth requiring no proof
AYE	an affirmative vote, one who votes in the affirmative
AZAN	(Islam) the call to prayer proclaimed five times a day
AZURE	a light, purplish shade of blue
BADGER	to pester, to annoy persistently
BAFFLE	totally bewilder, confuse or perplex
BAILIFF	a legal officer, similar to a sheriff or deputy
BAIZE	a woollen fabric resembling felt
BALE	a large, wrapped bundle of something (ie, cotton, hay)
BALEFUL	harmful ominous causing evil
BALK	obstacle purposely to get on the way of
BALLAST	any heavy material used to stabilize a ship
BALSAM	a sweet-smelling oil or resin derived from various plants
BANAL	so lacking in originality as to be obvious and boring
BANDY	to give and receive reciprocally, to exchange
BANE	a cause of great distress or annoyance
BANEFUL	causing harm or ruin pernicious destructive
BANTER	the playful and friendly exchange of teasing remarks
BAR	except fro, apart from
BARB	a sharp projection near the end of an arrow or similar item
BARD	a poet, often one who plays an instrument
BARRAGE	artificial obstacle built across a river
BARREN	empty, vacant
BASHFUL	shy, inclined to avoid notice
BASK	in enjoy warmth and light
BASS	of sound which is low in pitch or frequency
BASTE	to sew with long, loose stitches
BASTION	a projecting part of a rampart or other fortification
BATHOS	depth, bottom
BATON	a short stick or staff used to conduct
BATTEN	to become better, improve in condition
BATTERY	a fortified emplacement for heavy guns
BAUBLE	a cheap showy ornament piece of jewellery, a gewgaw
BAWDY	soiled, dirty
BAWL	to shout or utter in a loud and intense manner
BEAM	to emit beams of light, shine, radiate,
BEATIFY	to bless make happy or ascribe a virtue to
BEAU	a frequent or attentive male companion
BECALM	to make calm or still, make quiet, calm
BECK	a stream or small river
BEDAUB	to smear upon, to soil
BEDECK	to deck, ornament, or adorn, to grace
BEDIZEN	to adorn especially in a cheap showy manner
BEDLAM	a place or situation of chaotic uproar
BEFOG	to envelop in fog
BEGET	to cause, to produce
BEGUILE	to deceive or delude craftily
BEHEST	to promise, vow
BELABOR	beat hard
BELAY	to surround, environ, enclose
BELIE	to lie around, encompass
BELLE	an attractive woman
BEMOAN	to complain about, to dismay or worry about something
BEMUSE	to confuse or bewilder
BENEFIT	to be or to provide a benefit to
BENIGN	gentle, kindly
BENISON	a blessing, benediction
BENT	curved, crooked
BEQUEST	arrangement to give smth at death
BERATE	scold sharply
BEREAVE	to deprive by or as if by violence, rob, strip
BEREFT	deprived
BERET	a type of round, brimless cap with a soft top and a headband
BERSERK	furiously violent or out of control
BERTH	to bring (a ship or vehicle) into its berth
BESEECH	to beg or implore
BESET	to surround or hem in
BESMEAR	to smear over, sully
BESTIAL	beast-like
BESTOW	to lay up in store, deposit for safe keeping, stow, place
BESTREW	to strew or scatter about, throw or drop here and there
BETHINK	to think about, to recollect
BETIDE	to happen to
BETIMES	before the usual or expected time
BETROTH	to promise to give in marriage
BEVEL	to give a canted edge to a surface
BICKER	to quarrel in a tiresome, insulting manner
BIDE	(chiefly dialectal) to bear, to endure, to tolerate
BIER	a litter to transport the corpse of a dead person
BIGAMY	the state of having two spouses simultaneously
BIGHT	a corner, bend, or angle
BIGOT	a person utterly intolerant of any differing opinion
BILGE	bulge the protuberance of a cask
BILIOUS	peevish, irritable
BILK	to obtain money fraudulently
BILLOW	present participle of billow
BIPED	an animal, or being that goes about on two feet or legs
BIVOUAC	to set up camp
BIZARRE	strangely unconventional in style or appearance
BLANCH	to grow or become white
BLAND	mild, soft, gentle
BLARE	to make a loud sound
BLASE	uninterested because of frequent exposure or indulgence
BLATANT	noisy and rough
BLAZE	a bright flame or fire
BLAZON	to describe a coat of arms
BLEAK	bare, desolate
BLEMISH	spoil the appearance of
BLIGHT	to suffer blight
BLITHE	cheerful casual carefree
BLOATED	swollen, puffed up
BLUFF	to mislead by a display of self-confidence or strength
BLUNDER	to make a stupid mistake
BLURT	to speak quickly or without thought
BODE	to indicate by signs, as future events
BODICE	the part of a woman's dress covering between neck and waist
BODILY	of, relating to, or concerning the body
BOGUS	counterfeit or fake, not genuine
BOLE	the trunk or stem of a tree
BOLERO	a lively spanish dance
BOLL	the rounded seed-bearing capsule of a cotton or flax plant
BOLSTER	give greatly needed support
BOMB	to attack using one or more bombs, to bombard
BOMBARD	to attack something with bombs or other missiles
BOMBAST	high-sounding language with little meaning
BON MOT	a witty remark or comment, clever saying, witticism
BONDAGE	the state of being enslaved or the practice of slavery
BOOMING	having a great period of prosperity
BOON	a thing that is helpful or beneficial
BOOR	a rude, unmannerly person
BOORISH	crude offensive rude
BOROUGH	a fortified town, a town or city
BOSOM	in a very close relationship
BOTANY	the scientific study of plants, a branch of biology
BOVINE	of, relating to, or affecting cattle
BOWLER	one who engages in the sport of bowling
BOYCOTT	to abstain, either as an individual or group
BRAE	the sloping bank of a river-valley, any slope or hillside
BRASH	hasty rush cheeky saucy
BRASS	yellow metal (mixing copper and zinc)
BRAVADO	a swaggering show of defiance or courage
BRAWN	strong, well-developed muscles
BRAY	of a donkey, to make it cry
BRAZE	the joining together of two metal pieces without melting
BRAZEN	bold and without shame
BRAZIER	a barbecue
BREACH	an act of breaking a law, agreement or code of conduct
BREADTH	the extent or measure of how broad or wide something is
BREAKER	something that breaks
BREECH	the lower, rear trunk of the body
BREVITY	concise and exact use of words in writing or speech
BRIDLE	part of the harness of a horse, consisting of bit and reins
BRIGADE	to form troops into a brigade
BRIGAND	an outlaw or bandit
BRINE	to preserve food in a salt solution
BRISTLE	to be on one's guard or raise one's defenses
BRITTLE	easily broken
BROACH	bring up announce begin to talk about
BROGAN	a heavy working shoe, a brogue
BROGUE	to speak with an accent
BROMIDE	a binary compound of bromine and some other element
BROMINE	a non-metallic chemical element, one of the halogens
BROOCH	women’s jewellery having a pin to be fixed to garments
BROOK	to tolerate endure
BROWSE	to casually look through in order to find items of interest
BRUIT	to spread, promulgate or disseminate a rumour, news etc
BRUNT	the chief consequences or negative results of something
BRUSQUE	rudely abrupt, unfriendly
BUCOLIC	a pastoral poem
BUFFET	a blow, typically with the hand or fist
BUFFOON	to behave like a buffoon
BULBOUS	having the shape of or resembling a bulb, bloated
BULLION	a bulk quantity of precious metal, usually gold or silver
BULLOCK	a castrated bull
BULRUSH	any of several wetland herbs
BULWARK	to fortify something with a wall or rampart
BUNGLE	to botch up, bumble or incompetently perform a task
BUOYANT	able to float light-hearted
BUREAU	office
BURGEON	begin to grow or increase rapidly
BURGESS	an inhabitant of a borough with full rights, a citizen
BURGHER	a citizen, especially one belonging to middle class
BURLY	large, well-built, and muscular
BURNISH	to make smooth or shiny by rubbing, to polish, to shine
BURSAR	the treasurer of a university, college or school
BUSTLE	to move busily and energetically with fussiness
BUTTE	an isolated hill with steep sides and a flat top
BUXOM	having a voluptuous figure, especially having large breasts
BYLAW	a rule governing a corporation or society's internal affairs
BYLINE	a line in a newspaper naming the writer of an article
CABAL	a scheme or plot a group of plotters
CABINET	a cupboard for storing or displaying articles
CADAVER	a dead body, especially of a human to be dissected
CADENCE	a modulation or inflection of the voice
CADENZA	an elaborate solo passage in a piece of music
CADET	a student in training at a military school
CADGE	ask for or obtain something to which one is not entitled
CAITIFF	especially despicable, cowardly
CAJOLE	persuade someone to do something by flattery or coaxing
CALIBRE	degree of capacity or competence, ability
CALLOUS	showing a cruel and insensitive disregard for others
CALLOW	immature or inexperienced
CALUMNY	a misrepresentation intended to discredit another
CALVARY	a sculpture of the crucifixion on a piece of raised ground
CALVISH	like a calf, stupid
CAMEO	a brief appearance of a prominent actor in a video
CANARD	a false or misleading report, especially if deliberately so
CANARY	to dance nimbly (as in the canary dance)
CANDID	frank straight-forward
CANDOR	whiteness, brilliance
CANINE	of, or pertaining to, a dog or dogs
CANNY	careful, prudent, cautious
CANON	a generally accepted principle
CANT	insincere talk/jargon
CANTATA	a vocal composition accompanied by instruments
CANTER	to move at such pace
CANTO	one of the chief divisions of a long poem, a book
CANVAS	to cover an area or object
CANVASS	discuss thoroughly sort of touting
CAPRICE	a sudden and unaccountable change of mood or behavior
CARCASS	body of a dead animal
CARDIAC	pertaining to the heart
CAREEN	turn (a ship) of its side for cleaning or repair
CARET	a mark made in writing to show something is to be inserted
CARNAGE	death and destruction
CARNAL	relating to the physical and especially sexual appetites
CAROUSE	to engage in a noisy or drunken social gathering
CARP	to complain about a fault, to harp on
CARRION	dead flesh, carcasses
CASTE	any hereditary social class of south asian societies
CATHODE	the electrode by which current leaves an electrolytic cell
CAUCUS	to hold or form such a group or meeting
CAUSAL	of, relating to, or being a cause of something, causing
CAUSTIC	biting sarcastic
CAVEAT	to qualify a particular statement with a proviso or caveat
CAVIL	to make petty or unnecessary objections
CAVORT	to prance, said of mounts
CEDE	to give up, give way, give away
CENSOR	to review in order to remove objectionable content
CENSURE	expression of blame or disapproval a rebuke
CENSUS	survey
CEREAL	any plant of the grass family with an edible grain
CESSION	that which is ceded
CHAFE	to wear or abrade by rubbing
CHAFF	to use light, idle language by way of fun or ridicule
CHAGRIN	to bother or vex, to mortify
CHAOS	complete disorder and confusion
CHARY	cautious wary
CHASM	a deep, steep-sided rift, gap or fissure, a gorge or abyss
CHASSIS	frame, landing gear
CHASTE	abstaining from sexual intercourse, celibate
CHATEAU	castle
CHATTEL	a movable article of personal property
CHERISH	to treat with tenderness and affection
CHIDE	to scold or rebuke
CHIFFON	a sheer silk or rayon fabric
CHIMERA	any creature with parts from different animals
CHISEL	steel tool for shaping materials
CHOLERA	any of several acute infectious diseases
CHORAL	of, relating to, written for, or performed by a choir
CHRONIC	that continues over an extended period of time
CHURL	bad-tempered person
CITADEL	a strong fortress that sits high above a city
CITE	to quote
CLAMBER	to climb something with some difficulty
CLAMOR	a loud and confused noise
CLAN	a group of people all descended from a common ancestor
CLAQUE	a group of people hired to attend a performance to applaud
CLARIFY	to make clear or intelligible
CLARION	loud and clear
CLEAVE	to split or sever something
CLEFT	a space or opening made by cleavage, a split
CLEMENT	lenient or merciful, charitable
CLERGY	body of persons who are ordained for religious service
CLICHE	a trite, stereotyped expression
CLINCH	come to grips/settle conclusively
CLING	to resist separation
CLIQUE	a small, exclusive group of individuals, cabal
CLOT	half-solid lump formed from liquid
CLOTURE	closing device (in Parliament) to end a debate by voting
CLOY	to fill up or choke up, to stop up
CLUMSY	awkward, lacking coordination, not graceful, not dextrous
COAX	get smb to do smth by kindness
COBBLER	a person who repairs shoes
CODA	passage that completes a piece of music
CODDLE	to treat in an indulgent or overprotective way
CODICIL	a document that amends a previously executed will
COERCE	compel to force to make obedient
COEVAL	of the same period coexisting
COGENT	strong convincing
COGNATE	related by birth, of the same parentage
COHERE	to stick together
COLLAGE	a work of art, made from assembling different items into one
COLLATE	to gather pages in their proper sequence
COLLIDE	to impact directly, especially if violent
COLLIER	a ship for carrying coal
COMELY	(woman) pleasant to look at, agreeable
COMICAL	funny, amusing
COMMEND	to praise formally or officially
COMMUTE	to travel from one's home to one's workplace
COMPEL	(literally) to drive together, round up
COMPLEX	to form a complex with another substance
COMPORT	to tolerate, bear
COMPUTE	to reckon or calculate
CONCEAL	hide keep secret
CONCEDE	to yield or suffer, to surrender, to grant (a point)
CONCEIT	over-high opinion of too much pride
CONCISE	brief but comprehensive
CONCOCT	to create or devise
CONCORD	agreement or harmony
CONCUR	agree in opinion happen together
CONDEMN	to sentence (someone) to a particular punishment
CONDONE	accept and allow (morally wrong or offensive behavior)
CONDUCE	to contribute or lead to a specific result
CONDUIT	a tube for protecting electric wiring
CONFER	to discuss, exchange opinions
CONFIDE	to trust, have faith (in)
CONFORM	to act in accordance with expectations
CONGEAL	make or become stiff and solid
CONGEST	to overfill or overcrowd
CONJOIN	to join together
CONNIVE	to cooperate with others secretly in order to commit a crime
CONNOTE	to signify beyond its literal or principal meaning
CONQUER	to defeat in combat, to subjugate
CONSIGN	to transfer to the custody of for sale, transport, etc.
CONSOLE	give comfort or sympathy to
CONSORT	a wife, husband, or companion
CONSUL	official in a country who protects their nation's interests
CONSUME	get to the end of
CONTEMN	to scorn or despise
CONTEND	to strive in opposition, to contest, to dispute
CONTEXT	the circumstances that form the setting of an idea
CONTORT	to twist in a violent manner
CONTUSE	to injure without breaking the skin, to bruise
CONVENE	to come together, to meet, to unite
CONVEX	curved or bowed outward like the outside of a circle
CONVEY	to make an idea or feeling know or understandable
CONVOKE	call together summon
CONVOY	to escort a group of vehicles, and provide protection
COPIOUS	abundant in supply or quantity
CORDIAL	warm and friendly, courteous
CORDON	line (of police acting as a guard)
CORNICE	an ornamental molding around the top of the wall of a room
CORONET	a circular decoration for the head
CORPS	a battlefield formation composed of two or more divisions
CORRODE	to eat away by degrees, to wear away or diminish gradually
COSMIC	of or from or pertaining to the cosmos or universe
COSMOS	the universe seen as a well-ordered whole
COSSET	to care for and protect in an overindulgent way
COTERIE	a circle of people who associate with one another
COUP	a highly successful, unexpected act
COURSE	to run or flow, especially of liquids
COURSER	a person who hunts with dogs using sight rather than scent
COVERT	disguised
COVET	to yearn to possess or have (something)
COVEY	a small group of people or things
COWER	crouch shrink back
COY	artfully or affectedly shy or reserved
COZEN	to cheat, deceive or trick
CRAG	a rocky outcrop
CRANIUM	the skull of a vertebrate
CRASS	lacking in sensitivity or due consideration
CRAVAT	piece of linen worn as a necktie
CRAVE	to feel a powerful desire for (something)
CRAVEN	cowardly
CREAK	to make a prolonged sharp grating or squeaking sound
CREASE	line made by crushing white line on the ground in cricket
CREED	any system, doctrine or formula of religious belief
CREVICE	a narrow crack or fissure, in a rock or wall
CRINGE	to bow or crouch in servility
CRUSADE	to make a grand concerted effort toward some cause
CRUSH	press lose shape subdue overwhelm
CRYPTIC	having a meaning that is mysterious or obscure
CUBICLE	a small separate part or one of the compartments of a room
CUDGEL	a short, thick stick used as a weapon, like a club
CULL	to pick or take someone or something (from a larger group)
CULPRIT	the person or thing at fault for a problem or crime
CULVERT	a channel under a road or railway for the draining of water
CUNNING	having or showing skill in achieving one's ends by deceit
CURABLE	able of being cured
CURATOR	a keeper or custodian of a museum or other collection
CURIO	a strange and interesting object which invokes curiosity
CURSIVE	(handwriting) in flowing strokes with the letters connected
CURSORY	hasty and therefore not thorough or detailed
CURT	brief or terse, especially to the point of being rude
CURTAIL	make shorter then was planned
CURTSY	a respectful bow made by women and girls
CYCLOID	resembling a circle, cyclical
CYGNET	a young swan
CYNIC	churlish or satirical
CYNICAL	believing that people are motivated by self-interest
DABBLE	to work at anything in an irregular or superficial manner
DAINTY	pretty/delicate(food)/difficult to please
DANK	unpleasantly moist or humid
DAPPER	neat, trim
DARE	to have the courage to do something
DARKLE	uncannily or threateningly dark or obscure
DASTARD	meanly shrinking from danger, cowardly
DATUM	a single piece of information
DAUNT	intimidate make fearful
DAWDLER	person who is slow waste of time
DEACON	a member of the clerical order below that of a priest
DEARTH	a scarcity or lack of something
DEBACLE	a breakup overthrow sudden disaster
DEBASE	to reduce in quality or value
DEBAUCH	to morally corrupt someone, to seduce
DEBRIS	rubble, wreckage, scattered remains of something destroyed
DEBUNK	to discredit, or expose the exaggerated claims of something
DEBUT	to formally introduce, as to the public
DECAGON	a polygon with ten sides and ten angles
DECAMP	to break up camp and move on
DECAPOD	having ten legs
DECEIT	an act or practice intended to deceive, a trick
DECEIVE	to trick or mislead
DECENCY	conformity to accepted standards of respectability
DECIMAL	pertaining to or proceeding by tenths or the power of ten
DECORUM	appropriate social behavior, propriety
DECOY	a person who entices or lures another person or thing
DECREE	order given by authority
DECRY	disapprove of
DEDUCE	to reach a conclusion from something known or assumed
DEFACE	to damage something in a visible or conspicuous manner
DEFAME	to try to diminish the reputation of
DEFER	postpone give way (to show respect)
DEFIANT	showing open resistance, provocative
DEFILE	to make impure, to make dirty
DEFLECT	to make (something) deviate from its original path
DEFORM	to remove the form of
DEFRAUD	to obtain money or property by fraud, to swindle
DEFRAY	to spend (money)
DEFT	quick and neat in action, skillful
DEFUNCT	no longer existing or functioning
DEFUSE	to reduce the danger or tension in (a difficult situation)
DEGRADE	to lower in value or social position
DEIFY	to make a god of (something or someone)
DEIGN	to condescend, to accept as appropriate to one's dignity
DEIST	someone who believes in the existence of a supreme being
DEITY	a god or goddess, divine status
DEJECT	make sad or dispirited
DELUDE	to deceive someone into believing something which is false
DELUGE	great flood heavy rush of water
DEMEAN	to debase, to do something that is beneath one's dignity
DEMERIT	a quality of being inadequate, a fault, a disadvantage
DEMISE	a person's death
DEMOTE	to lower the rank or status of something
DEMUR	to hesitate raise objections
DEMURE	reserved, modest, and shy
DENIZEN	to grant rights of citizenship to, to naturalize
DENOTE	to indicate, to mark
DENUDE	to divest of all covering, to make bare or naked, to strip
DEPLETE	to decrease seriously or exhaust the supply of (something)
DEPLORE	to bewail, to weep bitterly over, to feel sorrow for
DEPLOY	to arrange (usually a military unit or units) for use
DEPORT	to expel someone from a country
DEPRAVE	make morally bad corrupt
DEPRESS	to press down on
DEPTH	the vertical distance below a surface
DERIDE	to harshly mock, ridicule
DERIVE	to deduce (a conclusion) by reasoning
DERRICK	a crane with a movable pivoted arm for moving heavy objects
DESCENT	an action of moving downward, dropping, falling
DESCRY	catch sight of see smth in the distance
DESERT	to leave, to abandon, to forsake
DESIST	to cease to proceed or act, to stop
DESPAIR	to give up as beyond hope or expectation, to despair of
DESPITE	in spite of
DESPOND	to give up the will, courage, or spirit
DESPOT	a ruler with absolute power who exercise it cruelly
DETER	discourage hinder
DETEST	to dislike intensely
DETRACT	to take away, to withdraw or remove
DETRUDE	to push downwards with force
DEVELOP	to grow or cause to grow and become more mature
DEVIATE	to go off course from, to change course, to change plans
DEVILRY	wicked activity
DEVIOUS	showing skillful use of underhanded tactics to achieve goals
DEVISE	to use one's intellect to plan or design (something)
DEVOID	empty, having none of, completely without
DEVOUR	to eat (food or prey) hungrily or quickly
DEVOUT	devoted to religion or to religious feelings and duties
DIALECT	a socially or geographically distinct variant of a language
DICTATE	to order, command, control
DICTION	the style of enunciation in speaking or singing
DICTUM	an authoritative statement, a dogmatic saying
DIDDLE	to cheat, swindle, hoax
DIFFUSE	to pour out and spread, as liquid
DIGRAPH	a directed graph
DIGRESS	to deviate from the main subject in writing or speaking
DILATE	speak comprehensively become wider large
DILEMMA	a situation requiring a choice between undesirable options
DILUTE	to make thinner by adding a liquid or solvent
DIMLY	dull and subdued, indistinct
DIN	a loud, unpleasant, and prolonged noise
DIORAMA	a model representing a scene with 3d figures
DIRGE	a funeral song or tune, expressing mourning for the dead
DISARM	to take away the weapons of, to render defenceless
DISAVOW	to disown, to repudiate, to refuse to acknowledge
DISBAND	cause (an organized group) to break up
DISCARD	to throw away, to reject
DISCERN	see with an effort but clearly
DISCORD	disagreement between people
DISDAIN	look on with contempt
DISMAL	disappointingly inadequate
DISOWN	to refuse to own or to refuse to acknowledge one’s own
DISPEL	to drive away by scattering, or to cause to vanish
DISROBE	to undress someone or something
DISRUPT	to throw into confusion or disorder
DISSECT	to cut apart (something) to study its anatomy
DISSENT	have a different opinion refuse to assent
DISTEND	to extend or expand, as from internal pressure, to swell
DISTILL	to make something (esp. a liquid) in this way
DISTORT	to bring something out of shape
DITHER	to be uncertain or unable to make a decision about something
DIURNAL	happening during daylight, or active during that time
DIVA	any female celebrity, usually a well known singer or actress
DIVERSE	showing a great deal of variety
DIVERT	to turn aside from a course
DIVEST	to undress, disrobe
DIVINE	to foretell (something), especially by the use of divination
DIVISOR	a number or expression that another is to be divided by
DIVULGE	make known smth secret
DOCILE	yielding to control or supervision, direction, or management
DOCKET	a calendar or list of cases for trial
DOE	the female of the deer, antelope, and certain other animals
DOFF	to remove a hat as a greeting or mark of respect
DOGGED	persistent in effort, stubbornly tenacious
DOGMA	an official system of tenets, laid down by an authority
DOLEFUL	mournful, bringing feelings of sadness
DOLOR	sorrow, grief, misery or anguish
DOLT	a stupid person
DOMAIN	a geographic area owned by a single person or organization
DON	to put on (clothes)
DONATOR	one who donates
DONEE	someone who receives a gift from a donor
DONOR	one who donates, typically, money
DORMANT	in a state of inactivity but awaiting development
DOTARD	a person with impaired intellect, especially an old person
DOTE	show much fondness center one's attention
DOUBLET	a close-fitting jacket, men's wear in the renaissance
DOUR	stern, harsh and forbidding
DOWDY	plain and unfashionable in style or dress
DOWRY	the money,or goods a wife brings to her husband at marriage
DRACHMA	the currency of greece until 2001, with the symbol ?
DRAGNET	a net dragged across the bottom of a body of water
DRAGOON	to force someone into doing something, to coerce
DRASTIC	extreme, severe
DRAWL	slow way of speaking
DRIVEL	childish, silly or meaningless talk
DROLL	amusing in an odd way
DRONE	male bee person who isn't self-employed
DROSS	something regarded as worthless, rubbish
DROUGHT	a period of dry weather, especially injurous to crops
DROWSY	inclined to drowse, heavy with sleepiness, lethargic, dozy
DRUB	to hit or beat (someone) repeatedly, thrash
DUBIOUS	feeling doubt
DUCTILE	capable of being made into thin wire without breaking
DUD	no use person smth that fails
DUET	a performance by two people, esp. musicians
DULCET	melodious harmonious
DUN	to ask or beset a debtor for payment
DUPE	cheat make a fool of
DUPLEX	something having two parts
DURANCE	confinement or restraint by force, imprisonment
DURESS	coercion, compulsion by threat or force
DUTEOUS	willingly obedient out of a sense of duty and respect
DUTIFUL	accepting of one's obligations and willing to do them well
DWARF	person or smb much below the usual size
DWINDLE	to decrease, shrink, diminish, reduce in size
DYNAMIC	characterized by constant change, activity, or progress
DYNAMO	a generator something that produces electric current
DYNE	a unit of force in the cgs system. symbol: dyn
EARNEST	ardent in the pursuit of an object, eager to obtain or do
EATABLE	able to be eaten, edible
ECHELON	a level or rank in an organization
ECLAT	brilliance of success or effort, splendor
ECLIPSE	the complete or partial interception of light from a star
ECSTASY	intense pleasure
EDDY	circular or spiral movement (e.g.. of wind)
EDIBLE	fit to be eaten/not poisonous
EDICT	a proclamation of law or other authoritative command
EDIFICE	a building, esp. a large and imposing one
EDIFY	to instruct or improve (someone) morally or intellectually
EDUCE	to draw out or bring out, elicit or evoke
EFFACE	to erase (a mark) from the surface
EFFETE	infertile worn out weak
EFFIGY	a dummy or crude representation of something that is hated
EFFUSE	to give (a liquid, light, smell, or quality)
EGOISM	the tendency to think of self and self-interest
EGOIST	a conceited and self-centered person
EGOTISM	a tendency to talk excessively about oneself
EGOTIST	a person who talks excessively about himself
EGRESS	to exit or leave, to go or come out
ELAN	spirit, zeal, ardor
ELAPSE	to pass or move by
ELATED	very happy or proud, jubilant, in high spirits
ELEGY	a lament a melancholy composition
ELICIT	draw out
ELITE	of high birth or social position, aristocratic or patrician
ELIXIR	a liquid which converts lead to gold
ELUDE	to evade, or escape from someone or something through skill
ELUSION	the act, or abstract properties, of eluding
ELUSIVE	evading capture, comprehension or remembrance
EMANATE	to come from a source, stem out of
EMBARGO	any restriction placed on commerce by a government
EMBARK	to get on a boat or ship or (outside the usa) an aeroplane
EMBLEM	a representative symbol, such as a trademark or logo
EMBODY	to represent in a physical form, to incarnate or personify
EMBROIL	to draw into a situation, to cause to be involved
EMEND	make corrections and improvements to a text
EMERGE	to come into view
EMINENT	(a person) famous and respected within a particular sphere
EMIT	to send out or give off
EMOTE	stir up excite
EMPATHY	the ability to understand and share the feelings of others
EMPOWER	to give permission or power to do something
EMULATE	to match or surpass (a person or achievement) by imitation
ENACT	to make (a bill) into law
ENAMOR	to attract, to capture
ENCAMP	to build and/or inhabit a camp or temporary shelter
ENCLAVE	a country, or part thereof, that is surrounded by another
ENCORE	to call for an extra performance or repetition
ENDEAR	to make dear or precious
ENDEMIC	epidemic
ENDORSE	to support or give one's approval to, especially officially
ENDOW	to furnish, as with some talent, faculty, or quality
ENDUE	to invest or endow with some gift, quality, or faculty
ENDURE	to hold out against, sustain without impairment or yielding
ENGAGE	to occupy the attention or efforts
ENGRAVE	impress deeply
ENGROSS	to occupy completely, as the mind or attention
ENGULF	swallow up
ENHANCE	to raise to a higher degree, intensify, magnify
ENIGMA	a puzzling or inexplicable occurrence or situation
ENJOIN	to lay upon, as an order or command, to order, to charge
ENLIST	to join a cause or organization, especially military
ENMITY	a feeling or condition of hostility, hatred, animosity
ENNOBLE	to bestow with nobility, honour or grace
ENNUI	a listlessness or melancholia caused by boredom, depression
ENRAGE	to fill with rage, to provoke to frenzy or madness
ENSIGN	flag/badge
ENSNARE	to entrap, to catch in a snare or trap
ENTAIL	to imply or require
ENTHRAL	please greatly/enslave (fig)
ENTHUSE	to cause (someone) to feel enthusiasm or to be enthusiastic
ENTICE	tempt or persuade
ENTRAIL	the internal parts of the trunk of a body, the intestines
ENTREAT	ask earnestly
ENTREE	a dish served as the main course of a meal
ENTWINE	to twist or twine around something (or one another)
ENVENOM	to make poisonous
ENVOY	a representative, a diplomatic agent
ENZYME	a protein that catalyses a biological chemical reaction
EPIC	heroic, majestic, impressively great
EPICURE	a person who cultivates a refined taste, connoisseur
EPIGRAM	any witty, ingenious, or pointed saying tersely expressed
EPISTLE	a letter, or a literary composition in the form of a letter
EPITAPH	an inscription on a gravestone in memory of the deceased
EPITHET	adjective
EPITOME	a person or thing that is typical of a whole class
EPOCH	a period of history, esp. considered remarkable/noteworthy
EPODE	a lyric poem in which a short verse follws a long one
EQUABLE	steady regular
EQUINE	of or relating to a horse or horses
EQUITY	the quality of being fair or impartial, fairness
ERASURE	the action of erasing, deletion, obliteration
ERODE	to wear away by abrasion, corrosion or chemical reaction
ERR	to make a mistake
ERRANT	straying from the proper course or standard
ERRATIC	irregular in behaviour or opinion
ERSATZ	made in imitation, artificial
ERUDITE	characterized by great knowledge, learned or scholarly
ESCHEW	avoid
ESPOUSE	marry give one's support to
ESPRIT	spirit, enthusiasm
ESPY	to catch sight or, to perceive with the eyes, to discover
ESQUIRE	to attend, wait on, escort
ESSENCE	the inherent nature of a thing or idea
ESTEEM	to regard someone with respect
ESTUARY	coastal water body where ocean tides and river water merge
ETHOS	characteristic spirit of a culture, era, or community
EUGENIC	of bringing about improvement in produced offspring
EULOGY	an oration to honor a deceased person, usually at a funeral
EUPHONY	a pleasing pronunciation of letters and syllables
EUREKA	an exclamation of triumph at a discovery
EVADE	to get away from by artifice, to avoid by dexterity
EVASION	the act of eluding or avoiding, particularly some pressure
EVASIVE	tending to avoid making revelations about oneself
EVERT	to turn inside out
EVICT	to expel (one or more people) from their property
EVINCE	to show clearly to indicate
EVOKE	call up bring out
EVOLVE	to develop gradually
EWE	a female sheep, especially when fully mature
EXACT	strictly accurate or correct
EXALT	to raise in rank, honor, power, character, quality
EXCEED	to be larger, greater than (something)
EXCEL	to be better or do better than someone or something
EXCESS	more than is normal, necessary or specified
EXEMPT	to grant (someone) freedom or immunity from
EXERT	to put in vigorous action
EXHALE	to expel air from the lungs
EXHORT	to urge, advise, or caution earnestly, admonish urgently
EXHUME	to dig out of the ground, to take out of a place of burial
EXIGENT	urgent, needing immediate action
EXODUS	a sudden departure of a large number of people
EXOTIC	foreign, with the connotation of excitingly foreign
EXPAND	to change from a smaller size to a larger one
EXPANSE	a wide stretch, usually of sea, sky, or land
EXPEND	to consume or exhaust some resource
EXPIATE	to atone or make reparation for
EXPLOIT	brilliant achievement develop use selfishly
EXPOUND	to set forth or state in detail
EXPUNGE	to strike or blot out, erase
EXSCIND	to cut out cut away
EXTANT	in existence, still existing, not destroyed or lost
EXTINCT	no longer active
EXTOL	praise highly
EXTORT	obtain by threats violence
EXTRUDE	to push or thrust out
EXUDE	to discharge through pores, to emit, to give out
EXULT	to rejoice, be very happy
FACADE	the face of a building, especially the front
FACET	one of the small, polished plane surfaces of a cut gem
FACILE	easily accomplished or attained
FACTION	a group or clique within a larger group
FAD	a temporary fashion, notion, manner of conduct, etc
FALLACY	deceptive or false appearance, deceitfulness, deception
FALLOW	to make land fallow for agricultural purposes
FALTER	to waver or be unsteady
FAMINE	extreme and general scarcity of food, as in a country
FAMISH	to suffer or cause to suffer extreme hunger, starve
FANATIC	a person with an extreme enthusiasm or zeal, as in religion
FATHOM	to penetrate to the truth of, comprehend, understand
FATUOUS	foolish or inane, especially in an unconscious manner, silly
FAULTY	having or displaying faults not adequate or acceptable
FAUN	mythical woodland creature with pointed ears and short horns
FAUNA	animals of a given region or period considered as a whole
FAWN	to exhibit affection or attempt to please
FEALTY	fidelity, faithfulness
FEBRILE	feverish, or having a high temperature
FECUND	fertile
FEIGN	to represent by a false appearance of, to pretend
FEINT	a movement made in order to deceive an adversary
FELON	a person convicted of a felony
FELONY	an offense, as murder or burglary, of grave character
FERAL	existing in a natural state, not domesticated, wild
FERMENT	living organisms (yeasts, molds) that cause fermentation
FERNERY	specialized garden for the cultivation and display of ferns
FERRET	discover by searching search
FERTILE	capable of growing abundant crops, productive
FERVENT	having or showing great warmth or intensity of spirit
FERVID	heated or vehement in spirit, enthusiasm, etc
FERVOR	an intense, heated emotion, passion, ardor
FESTAL	festive, relating to a festival or feast
FESTIVE	having the atmosphere,or attitude of a celebration
FETE	to celebrate (a person)
FETID	having an offensive odor, stinking
FETISH	an object seen as being the habitation of a spirit
FETTER	to shackle or bind up with fetters
FETUS	an unborn vertebrate showing signs of the mature animal
FEUD	bitter quarrel over a long period of time
FEUDAL	of, or relating to the feudal system
FIASCO	a complete and ignominious failure
FIAT	an authoritative command or order, an effectual decree
FICKLE	likely to change, casually changeable
FIDGET	move restlessly make nervous
FIEF	a territory held in fee
FIGMENT	a fabrication, fantasy, invention, something fictitious
FILCH	to steal, to illegally take possession of
FILIAL	of, pertaining to, or befitting a son or daughter
FINERY	fine or showy dress, ornaments, etc
FINESSE	delicate way of dealing with a situation
FINICAL	too fussy about food clothing etc.
FINICKY	fastidious and fussy, difficult to please, exacting
FINITE	having bounds or limits, not infinite, measurable
FISCAL	related to the treasury of a country, company, or region
FISSION	splitting or division (esp. of cells)
FISSURE	narrow opening produced by cleavage or separation of parts
FITFUL	irregular, unsteady, characterized by fits
FIXATE	stare at
FIXTURE	to furnish with, as, or in a fixture
FLACCID	soft and limp, not firm, flabby
FLAIR	a natural or innate talent or aptitude, a knack
FLAK	criticism/anti-aircraft guns
FLAUNT	to parade, display with ostentation
FLAX	a plant of the genus linum which has a single, slender stalk
FLEDGED	able to fly trained experienced
FLEET	number of ships quick-moving
FLEXION	the act of bending a limb
FLIMSY	likely to bend or break under pressure, weak, shaky
FLINCH	draw move back wince
FLOE	a low, flat mass of floating ice
FLOP	fail/move/fall clumsily
FLORA	plants considered as a group, esp. those of one region
FLORAL	of, pertaining to, or connected with flowers
FLORID	having a rosy or pale red colour, ruddy
FLORIST	a person who sells flowers
FLOTSAM	debris floating in a sea, fragments from a shipwreck
FLOUT	reject mock to go against (as in going against tradition)
FLUE	a pipe or duct that carries gaseous combustion products away
FLUENT	able to speak a language accurately, rapidly and confidently
FLUGEL	a grand piano or harpsichord, both being wing-shaped
FLUKE	lucky stroke
FLUSTER	make nervous or confused
FLUVIAL	of or pertaining to a river
FLUX	flowing or flow
FODDER	to feed animals (with fodder)
FOG	a cloudlike mass or layer of minute water droplets
FOIBLE	a minor weakness or failing of character, slight flaw
FOIL	prevent from carrying out contrast
FOIST	to introduce or insert surreptitiously or without warrant
FOLIAGE	the leaves of plants
FOLIO	a leaf of a book or manuscript
FOMENT	put smth warm (to lessen the pain)
FONDLE	to touch or stroke lovingly
FOOLERY	foolish behaviour or speech
FOPPERY	the dress or actions of a fop
FOPPISH	like a fop, a man overly concerned with his appearance
FORAGE	food for horses and cattle
FORAY	to scour (an area or place) for food, treasure, booty etc
FORBEAR	refrain from be patient ancestor
FORBID	to command not to do something, have something, etc
FORBY	close by, near
FORD	shallow place in a river (to cross)
FOREGO	to precede, to go before
FOREIGN	from a different country
FOREMAN	the leader of a work crew
FORERUN	to run in front
FORESEE	to anticipate, to predict
FORFEIT	suffer the loss of smth
FORFEND	to prohibit, to forbid, to avert
FORGE	to form by heating and hammering, beat into shape
FORGERY	counterfeit
FORGO	to let pass, to leave alone
FORLORN	desolate or dreary, as in feeling, condition
FORMULA	any fixed or conventional method for doing something
FORSAKE	to abandon, to give up, to leave (permanently), to renounce
FORTE	a person's strong suit, talent, or skill
FORTIFY	to protect or strengthen against attack
FORUM	a place for discussion
FOSTER	nurture care for
FOURTH	being one of four equal parts
FRACAS	a noisy, disorderly disturbance or fight
FRAGILE	easily broken or destroyed and often of subtle structure
FRAILTY	the condition of being frail, physically, mentally, etc
FRANTIC	desperate or wild with excitement, passion, fear, pain, etc
FRAUGHT	filled or charged
FRAY	to unravel, used particularly for the edge of cloth
FRESCO	painting on a moist, plaster surface
FRET	worry irritation wear away
FRETFUL	irritable, bad-tempered, grumpy or peevish
FRIEZE	a decorative band beneath the cornice of an interior wall
FRIGID	very cold, lacking warmth, icy
FRINGE	edge ornamental border part of hair over the forehead
FRISSON	a sudden surge of excitement, shudder of emotion, thrill
FRIZZ	of hair, to form into a mass of tight curls
FRIZZLE	to fry something until crisp and curled
FRONTAL	of, in, or at the front
FROWARD	intractable not willing to yield or comply stubborn
FROWZY	dirty and untidy, slovenly
FRUGAL	avoiding unnecessary expenditure either of money
FULCRUM	the support about which a lever pivots
FULSOME	disgusting offensive due to excessiveness
FUNGOUS	of or pertaining to a fungus, fungal
FUNGUS	any member of the kingdom fungi
FURBISH	to polish or burnish
FURLONG	a unit of distance, equal to 220 yards or 0.2 km
FURRIER	comparative form of furry, more furry
FURROW	to make (a) groove, a cut(s) in (the ground etc )
FURTHER	to encourage growth
FURTIVE	taken, done, used, etc , surreptitiously or by stealth
FUSE	to melt together, to blend, to mix indistinguishably
FUSIBLE	able to be fused or melted
FUSTIAN	a kind of coarse twilled cotton or cotton and linen stuff
FUTILE	incapable of producing any result, ineffective, useless
GAFFE	a foolish and embarrassing error, esp one made in public
GAIETY	the state of being happy
GAILY	merrily, joyfully
GAINSAY	to deny to oppose
GAIT	a manner of walking, stepping, or running
GALLANT	brave, valiant
GALLEON	a large sailing vessel of the 15th to the 17th centuries
GALORE	in abundance
GAMBIT	an opening in chess, in which a minor piece is sacrificed
GAMBOL	to skip about, as in dancing or playing, frolic
GAMUT	a (normally) complete range
GAPE	to open the mouth wide as in a yawn or surprise
GARBLE	make unfair selection from facts
GARISH	overly ostentatious, so colourful as to be in bad taste
GARMENT	article of clothing
GARNER	to gather and save to store up
GARNISH	to decorate with ornamental appendages, to adorn
GARROTE	to execute by strangulation
GASEOUS	relating to, or existing as, gas
GASTRIC	of or relating to the stomach
GAUCHE	awkward or lacking in social graces, bumbling
GAUGE	to measure or determine capacity, character, or ability
GAUNT	lean, angular, and bony
GENERIC	very comprehensive, pertaining or appropriate to big groups
GENESIS	the origin or point at which something begins to exist
GENIAL	warmly and pleasantly cheerful, cordial
GENITAL	of, or relating to biological reproduction
GENTEEL	polite and well-mannered
GENTILE	non-jewish
GEOLOGY	science of the structure of the earth through study of rocks
GERMANE	related to the topic being discussed or considered
GESTURE	to make a gesture or gestures
GHASTLY	horrifyingly shocking
GIBE	to utter mocking or scoffing words
GIDDY	to make dizzy or unsteady
GIRDER	a beam of steel, wood,etc, used as a main support
GIST	the most essential part, the main idea or substance
GLACIAL	of, or relating to glaciers
GLACIER	a large body of ice which flows under its own mass
GLADDEN	to cause (something) to become glad
GLAZIER	a person who fits windows or the like with glass
GLEAN	gather facts in small quantities
GLIB	readily fluent, often thoughtlessly or insincerely so
GLIMMER	to shine with a faint light
GLIMPSE	to see or view briefly or incompletely
GLOAT	over look at with selfish delight
GLOBOSE	having a globular form
GLUT	supply to much fill to excess
GLUTTON	a person who eats and drinks excessively or voraciously
GNARLED	knotty and misshapen
GNASH	to grind one's teeth in pain or in anger
GNAW	waste away bite steadily
GOAD	smth urging a person to action
GORDIAN	resembling the gordian knot in intricacy
GORGE	eat greedily/narrow opening with a stream
GOSLING	a young goose
GOTHIC	a style of architecture from the mid-12th century
GOUGE	to scoop out or turn with or as if with a gouge
GOURD	the dried shell of a hard fruit used for utensils
GRANARY	a storage facility for grain or sometimes animal feed
GRANTEE	the person to whom something is granted
GRANTOR	a person who grants something
GRANULE	a tiny grain, a small particle
GRAPPLE	to seize something and hold it firmly
GRATE	to shred things, usually food, by rubbing across a grater
GRATIFY	to give pleasure by satisfying desires, to indulge
GRATIS	free, without charge
GRAVE	serious requiring consideration
GRAZE	touch or scrape lightly in passing
GRIMACE	to distort one's face, to make faces
GRISLY	horrifyingly repellent, terrifying, gruesome
GRISTLE	cartilage, especially in meats
GRITTY	containing sand or grit, full of hard particles
GROTTO	a cave or cavern
GROUSE	any gallinaceous birds of the subfamily tetraoninae
GROVEL	crawl humble oneself
GRUFF	to have a rough, surly, or harsh nature
GUESS	to reach a partly (or totally) unqualified conclusion
GUFFAW	to laugh boisterously
GUILE	deceit cunning
GUINEA	a coastal region in w africa
GUISE	general external appearance, aspect, semblance
GUSH	burst out suddenly/talk ardently
GUST	outburst of feeling sudden rain wind fire etc.
GUSTO	enthusiasm, enjoyment, vigor
GUZZLE	to drink quickly, voraciously, or to excess
GYRATE	to revolve round a central point, to revolve
HACK	cut roughly hired horse
HACKLES	the erectile hair on the back of an animal's neck
HACKNEY	to make uninteresting or trite by frequent use
HAGGARD	looking exhausted and unwell, in poor condition
HAIL	to cheer, salute, or greet, welcome
HALCYON	calm and peaceful
HALE	free from disease or infirmity, robust, vigorous
HALLOW	to make holy consecrate
HAMPER	to hold back, hinder, impede
HANGAR	a large garage-like structure where aircraft are kept
HAP	to happen, to befall, to chance
HAPLESS	unlucky, luckless, unfortunate
HARASS	to fatigue or to tire with repeated and exhausting efforts
HARDY	having rugged physical strength, inured to fatigue
HARROW	to distress create stress or torment
HASTE	swiftness of motion, speed
HAUGHTY	arrogant conceited
HAUTEUR	haughtiness or arrogance, loftiness
HAVOC	great destruction or devastation
HAZARD	an unavoidable danger or risk, even though often foreseeable
HECKLE	to harass with impertinent questions or gibes
HEED	attention/give notice to
HEIFER	a young female bovine (cow) that has not yet had a calf
HEINOUS	hateful, odious, abominable, totally reprehensible
HENCE	as an inference from this fact, for this reason, therefore
HENPECK	to nag persistently
HERESY	belief contrary to what is generally accepted
HERETIC	anyone who does not conform to an established doctrine
HERNIA	disorder where a part of the body protrudes through a tear
HEROINE	a woman of distinguished courage or ability
HEW	make by hard work cut (by striking)
HEXAGON	a polygon with six sides and six angles
HEXAPOD	having six feet, six-footed
HIATUS	a gap in a series, making it incomplete
HIDEOUS	frightful, shocking, extremely ugly
HILLOCK	a small hill
HINDER	to make difficult to accomplish, act as obstacle
HIRSUTE	hairy shaggy
HOARD	to amass, usually for one's personal collection
HOARSE	afflicted by a dry, quite harsh voice
HOARY	white or gray with age
HOAX	mischievous trick played on smb for a joke
HOC	the latin word for "this"
HOI	polloi the masses the rabble
HOLLOW	not soled with hole
HOLSTER	leather case for a pistol
HOMAGE	in feudalism, the oath of a vassal to honor a lord's rights
HOMILY	a sermon, especially concerning a practical matter
HOMONYM	word that sounds like another but has a different meaning
HONE	stone used for sharpening tools
HORDE	a wandering troop or gang
HOSIERY	stockings or socks of any kind
HUBRIS	arrogant pride
HUE	a gradation or variety of a color, tint
HUMANE	having regard for the health and well-being of another
HUMBLE	not proud or arrogant, modest
HUMBUG	to play a trick on
HUMDRUM	lacking variety, boring, dull
HUMMOCK	an elevated tract of land above the level of a marshy region
HUMUS	the dark organic material in soils
HUSH	make or become silent
HUSK	worthless outside part of anything
HUSSAR	one of the light cavalry of european armies
HUSTLE	to rush or hurry
HYBRID	the offspring of two animals or plants of different breeds
HYDRA	a nine-headed serpent, which when cut off grow back as two
HYDROUS	containing combined water, hydrated
HYGIENE	the science of health, its promotion and preservation
ICILY	in an icy manner
ICINESS	the state or quality of being icy or very cold, frigidity
IDIOM	a manner of speaking, a way of expressing oneself
IDOLIZE	to make an idol of, or to worship as an idol
IDYLL	a carefree episode or experience
IDYLLIC	of or pertaining to idylls, charmingly simple or rustic
IGNOBLE	dishonorable common undignified
ILLICIT	lacking licitness, but not invalid
IMBIBE	to drink (used frequently of alcoholic beverages)
IMBRUE	to stain (in, with, blood, slaughter, etc )
IMBUE	to stain an object completely with some physical quality
IMMENSE	huge, gigantic, very large
IMMERSE	to put under the surface of a liquid, to dunk
IMMORAL	not moral, inconsistent with rectitude or good morals
IMMUNE	exempt, not subject to
IMMURE	to cloister, confine, imprison, to lock up behind walls
IMPAIR	to weaken, to affect negatively
IMPART	to make known, to tell, to relate
IMPASSE	a situation from which there is no escape, deadlock
IMPEDE	hinder get in the way of
IMPEL	to urge a person, to press on, to incite to action or motion
IMPEND	to be about to happen or occur
IMPERIL	to put into peril, to place in danger or cause a hazard
IMPETUS	something that impels, a stimulating factor
IMPIETY	lack of reverence or dutifulness
IMPINGE	to make an impression, have an effect or impact
IMPIOUS	not pious or religious, lacking reverence for god, etc
IMPLY	to indicate or suggest without being explicitly stated
IMPUGN	to challenge as false,cast doubt upon
IMPURE	not pure, mixed with extraneous matter, contaminated
IMPUTE	to attribute to a cause or source ascribe
INANE	lacking sense/meaning, to the point of boredom or annoyance
INAPT	not apt, unsuitable, inept
INBORN	naturally present at birth, innate
INBRED	resulting from or involved in inbreeding
INCENSE	make angry
INCISAL	relating to the cutting edge of the incisor and cusped teeth
INCISE	engrave make a cut in
INCISOR	one of the front teeth of mammals, between the canines
INCITE	stir up rouse
INCUBUS	an evil spirit supposed to oppress people while asleep
INDICT	to accuse of wrongdoing, charge
INDUCE	to lead by persuasion or influence, incite
INDUCT	to formally or ceremoniously install in an office, position
INDULGE	(often followed by "in"): to yield to a temptation or desire
INEPT	not able to do something, not proficient
INERT	unable to move or act, inanimate
INERTIA	the property of a body that resists any change to its motion
INFAMY	extremely bad reputation, public reproach
INFER	to derive by reasoning, conclude from premises or evidence
INFERNO	hell
INFEST	to live in or overrun to an unwanted degree
INFIDEL	a non-believer of a certain religion
INFIRM	to contradict, to provide proof that something is not
INFLUX	a flow inward or into something
INFUSE	put pour fill
INGENUE	an innocent, naïve, wholesome girl or young woman
INGEST	take in by swallowing
INGRAFT	to insert, as of one plant into another, for propagation
INGRATE	ungrateful
INHIBIT	to hinder, to restrain
INHUMAN	of or pertaining to inhumanity and the indifferently cruel
INHUME	to bury in a grave
INJECT	to pump (especially fluids) into a cavity or passage
INKLING	a slight suspicion or hint
INLAND	within the land, remote from the ocean
INLET	an indentation of a shoreline, small bay or arm
INMOST	the very deepest within, innermost
INNATE	existing in one from birth, inborn, native
INQUIRE	to ask (about something)
INROAD	an advance into enemy territory, an attempted invasion
INSIGHT	a sight or view of the interior of anything, introspection
INSIPID	without distinctive, interesting, or stimulating qualities
INSTANT	an infinitesimal or very short space of time, a moment
INSTILL	to cause a quality to become part of someone's nature
INSULAR	of, pertaining to, being, or resembling an island or islands
INSULT	to treat or speak to insolently, with contemptuous rudeness
INTER	to bury in a grave
INTERIM	an intervening time, transitional, meantime
INTRUDE	to enter without permission
INURE	to come into use, take or have effect
INURED	accustomed to adapted
INVALID	an infirm or sickly person
INVEIGH	to attack verbally denounce deprecate
INVERSE	reversed position, direction, or tendency
INVERT	to turn (something) upside down or inside out
INVOKE	to call upon (a person, especially a god) for help
INVOLVE	to roll or fold up, to wind round, to entwine
IOTA	the ninth, and smallest, letter of the greek alphabet
IRATE	angry
IRE	anger
IRK	to irritate, annoy, bother
IRKSOME	disagreeable or troublesome, bothersome, annoying
IRONY	use of words to convey meaning opposite the literal meaning
ISLE	an island
ISLET	a small island
ISOBAR	atoms having equal weight but different atomis numbers
ISOLATE	to set apart or cut off from others
JABBER	talk excitedly utter rapidly
JADED	dulled or satiated by overindulgence
JARGON	a technical terminology unique to a particular subject
JAUNT	to ramble here and there, to stroll, to make an excursion
JEER	to utter sarcastic or mocking comments
JEJUNE	without interest or significance, dull
JIBE	gibe make fun of
JINGO	one who supports policy favouring war
JOCOSE	given to or characterized by joking, jesting, humorous
JOCULAR	characterized by, or intended for joking or jesting
JOCUND	cheerful, merry, gay, blithe, glad
JOGGLE	to shake slightly, to jostle, to jog
JOLLITY	the state of being jolly, cheerfulness
JOUST	to engage in mock combat on horseback
JOVIAL	endowed with or characterized by a hearty or joyous humor
JUGGLE	to manipulate objects, such as balls, clubs, etc artfully
JUGULAR	relating to, or located near, the neck or throat
JUROR	a member of a jury
JUT	to stick out
KEEN	to sharpen, to make cold
KERNEL	the body of a seed inside the husk
KILLJOY	a person who is anti-fun, or prevents others from having fun
KILN	a furnace or oven for burning, baking, or drying something
KINDLE	to start (a fire) or light (a torch)
KINDRED	of the same nature
KINETIC	pertaining to motion
KINFOLK	relatives or kindred
KISMET	fate, destiny
KNAVE	a tricky, deceitful fellow, a dishonest person, a rogue
KNAVERY	the (mis)behaviour of a knave, boyish mischief
KNEAD	to work into a mass by repeated pressure with the knuckles
KNELL	sound made by a bell rung slowly, especially for funerals
KNIT	draw together unite firmly
KNOLL	a small, rounded hill or eminence, hillock
KNOTTY	full of knots
KUDOS	praise, accolades
LACKEY	to attend, wait upon, serve obsequiously
LACONIC	using few words, concise
LACTEAL	relating to milk
LACTIC	of, relating to, or derived from milk
LADDIE	a small boy
LADLE	to serve something with a ladle
LAGGARD	hanging back, loitering
LAMENT	show feel great sorrow
LAMPOON	to satirize or poke fun at
LANCE	to pierce with a lance, or with any similar weapon
LANGUID	lacking in vigor or vitality, slack or slow
LANGUOR	a state of the body or mind caused by exhaustion or disease
LAPSE	to fall away gradually, to subside
LARCENY	the unlawful taking of personal property, theft
LARDER	a cool room in a domestic house where food is stored
LARGESS	generous bestowal of gifts
LASSIE	a young girl, a lass, especially one seen as a sweetheart
LATENCY	a delay between the initiation and occurence of something
LATENT	present but not visible, apparent, or actualized, potential
LATERAL	of or pertaining to, situated at, or directed to a side
LATISH	somewhat or rather late
LATTICE	a flat panel constructed with crossed thin strips of wood
LAUD	to praise, to glorify
LAVE	to pour or throw out, as water, lade out, bail
LAVISH	giving or producing freely liberally or generously
LAX	lenient and allowing for deviation, not strict
LAXITY	the state or quality of being lax
LEA	an open field, meadow
LEAFLET	a small flat or folded sheet of printed paper, advertisement
LEAVEN	to add a leavening agent
LECTERN	a stand with a slanted top used to support a bible
LEERY	cautious, hesitant, or nervous about something
LEEWARD	away from the direction from which the wind is blowing
LEGACY	anything handed down from the past, as from a predecessor
LEGGING	present participle of leg
LEGIBLE	being clear enough to be read, readable
LEGION	a division of the roman army of 3000 to 6000 soldiers
LEISURE	freedom provided by the cessation of activities
LENIENT	lax, tolerant of deviation, permissive, not strict
LEONINE	of, pertaining to, or characteristic of the lion
LEVEE	an embankment to prevent inundation
LEVER	to move with a lever
LEVITY	lack of seriousness
LEVY	to impose a tax or fine, to collect monies due
LEWD	lascivious, sexually promiscuous, rude
LEXICON	a wordbook or dictionary
LIABLE	bound or obliged in law or equity, responsible, answerable
LIAISON	communication between two parties or groups
LIBEL	statement that damages reputation
LICIT	not forbidden by formal or informal rules
LIEGE	sovereign, independent, having right to allegiance
LIEN	alternative form of lain
LIEU	see in lieu or in lieu of
LIMBER	bending readily, pliant, lithe
LIMN	paint portray
LIMP	lacking strength walking unevenly
LIMPID	clear, transparent, or pellucid, as water, crystal, or air
LINEAGE	descent in a line from a common progenitor, race
LINEAR	having the form of a line, straight
LINER	someone who fits a lining to something
LINGO	language, jargon or a dialect
LINGUA	language
LINGUAL	related to the tongue
LIONIZE	to treat (a person) as a celebrity
LIQUEFY	to make into a liquid by condensing a gas or melting a solid
LIQUEUR	a flavored alcoholic beverage that is usually very sweet
LIQUOR	to drink liquor, usually to excess
LISSOME	lithe, quick and graceful in movement
LITANY	a prolonged or tedious account
LITERAL	exactly as stated, understood without extra interpretation
LITHE	bending readily, pliant, limber
LITURGY	a form of public worship, ritual
LIVID	enraged, furiously angry
LOAM	a rich, friable soil
LOATH	unwilling, reluctant, averse, disinclined
LOATHE	to hate, detest, revile
LOCH	a lake
LODE	a rich supply or source
LOFTY	high, tall, having great height or stature
LOGIC	the principles governing correct or reliable inference
LOGICAL	in agreement with the principles of logic
LOLL	rest to sit or stand in a lazy way hang (dog's tongue)
LOOT	to steal, especially as part of war, riot
LOPE	move along with long strides
LOUGH	a lake or long, narrow inlet, especially in ireland
LOUSE	to remove lice from the body of a person or animal
LUCID	easily understood, completely intelligible or comprehensible
LULL	become quiet or less active
LUMBER	move in a clumsy/noisy way
LUMEN	the amount of light that falls on a unit area
LUMMOX	a clumsy, stupid person
LUNACY	the state of being mad, insanity
LUNAR	of, or pertaining to, the moon
LUNATIC	an insane person
LUNE	anything shaped like a crescent or a half moon
LURID	shocking, horrifying
LURK	be out of view ready to attack
LYING	characterized by luxury, ministering or conducive to luxury
LYNCH	to execute without a proper trial, especially by hanging
LYRE	a stringed musical instrument
MACABRE	gruesome suggesting death
MADDEN	to make angry
MAGNATE	a person of great influence in a particular field
MAGNET	a thing or person that attracts
MAIZE	corn, a type of grain of the species zea mays
MALADY	any ailment or disease of the human body
MALAISE	a feeling of general bodily discomfort or unpleasantness
MALARIA	disease characterized by chills, fever, and sweating
MALIGN	injurious speak ill of smb tell lie
MALLET	a hammerlike tool with a head commonly of wood
MANACLE	chains for the hands or feet
MANDATE	authorization to act in a particular way on a public issue
MANE	the long hair growing on the neck of some animals
MANIA	violent derangement of mind, madness, insanity
MANOR	a landed estate
MANTEL	the shelf above a fireplace
MANTLE	to cover or conceal (something)
MANUMIT	to release from slavery, to free
MAR	to damage or spoil, render less perfect, attractive
MARAUD	to roam or go around in quest of plunder
MARINE	pertaining to the sea (marine biology, marine insurance)
MAROON	to abandon in a remote, desolate place
MARQUEE	a large tent with open sides, used for outdoor entertainment
MARRED	impaired appearance
MARSHAL	to arrange troops etc in line for inspection or a parade
MARTIAL	of, relating to, or suggestive of war, warlike
MARTIAN	of or pertaining to the planet mars
MARVEL	to become filled with wonderment or admiration
MASONRY	the art or occupation of a mason, stonework
MASSIVE	of or pertaining to a large mass, weighty, heavy, or bulky
MASTERY	the position or authority of a master, command
MATINEE	the afternoon showing of a movie or theatrical performance
MATRIX	a thing constituting the point from which another originates
MATTER	to be important
MAUDLIN	sentimental in a silly or tearful way
MAUL	a heavy hammer, as for driving stakes or wedges
MAWKISH	characterized by sickly sentimentality, maudlin
MAXIM	an expression of a general truth or principle
MEAD	an alcoholic drink fermented from honey and water
MEAGER	deficient in quantity or quality, lacking fullness
MEANDER	to wind, turn, or twist, to make flexuous, to wander
MEDIAL	of or pertaining to a mean or average
MEDIATE	to resolve differences between conflicting parties
MEDLEY	a mixture, especially of heterogeneous elements, hodgepodge
MEEK	humbly patient or docile, as under provocation from others
MELANGE	a collection containing a variety of miscellaneous things
MELEE	a confused hand-to-hand fight among several people
MELLOW	soft, sweet, and full-flavored from ripeness, as fruit
MEMENTO	a keepsake, an object kept as a reminder of a place or event
MENACE	something that threatens to cause evil or harm, a threat
MENIAL	of or relating to work normally performed by a servant
MENTOR	a wise and trusted counselor or teacher
MERGE	to combine into a whole
METE	to measure
METTLE	a quality of endurance and courage
MIASMA	noxious exhalations from putrescent organic matter
MIDWIFE	a person trained to assist women in childbirth
MIEN	demeanor or attitude, especially one intended by its bearer
MIGRATE	to move from one region to another according to the seasons
MILEAGE	the total distance, in miles, travelled
MILIEU	a person’s social setting or environment
MILITIA	an army of trained civilians called upon in time of need
MILLET	any of a group of various types of grass used as food
MIMIC	to imitate, especially in order to ridicule
MINCE	pronounce or speak affectedly euphemize
MINION	favoured, beloved, "pet"
MINUTIA	a minor detail, often of negligible importance
MIRAGE	something illusory, without substance or reality
MIRE	to weigh down
MIRTH	gaiety or jollity, especially when accompanied by laughter
MISDEED	that which was done that should not have been
MISER	a person who lives in poor conditions in order to save money
MISERLY	like a miser, very covetous, stingy, cautious with money
MISHAP	an accident, mistake, or problem
MISLAY	to lose temporarily, misplace
MISRULE	of a trial judge, to make a bad decision in court
MISSAL	any book of prayers or devotions
MISSILE	an object intended to be launched into the air at a target
MISSIVE	a written message, a letter, note or memo
MISTY	with mist, foggy
MISUSE	to use (something) incorrectly
MITE	a minute arachnid
MITER	to finish a material at an angle, as with sides of a frame
MOAT	a deep ditch, usually filled with water, around a fort
MOCKERY	the action of mocking, ridicule, derision
MODICUM	a moderate or small amount
MODIFY	to make partial changes to
MODISH	conforming with fashion or style
MOLLIFY	make calmer or quieter
MOLT	moult lose hair feathers before new growing
MONARCH	a hereditary sovereign, as a king, queen, or emperor
MONGREL	someone of mixed kind or uncertain origin, especially a dog
MONTAGE	a single composition of images from various sources
MOOT	of little or no practical value or meaning, purely academic
MORALE	mental condition with respect to confidence, zeal, etc
MORASS	a tract of soft, wet ground, a marsh, a fen
MORBID	diseased unhealthy (e.g.. about ideas)
MORDANT	sharply caustic or sarcastic, as wit or a speaker, biting
MORES	a set of moral norms derived from accepted practices
MOROSE	gloomily or sullenly ill-humored, as a person or mood
MORTIFY	to humiliate or shame, as by injury to one's pride
MOSAIC	an image made of small, colored pieces of glass
MOTE	a small particle or speck, especially of dust
MOTIF	a recurring or dominant element, a theme
MOTLEY	comprising greatly varied elements, heterogeneous
MOTTLED	to mark with spots or blotches of a different color
MOTTO	a maxim adopted as an expression of a guiding principle
MUDDLE	to mix together, to mix up, to confuse
MUFFLE	to wrap up in fabric for warmth or protection
MUFFLER	cloth worn round the neck/silencer
MULATTO	a person of mixed african and caucasian descent
MUNDANE	common, ordinary, banal, unimaginative
MURKY	hard to see through, as a fog or mist
MUSE	to become lost in thought, to ponder
MUSTER	to gather, summon, rouse (often followed by up )
MUSTY	having a stale odor
MUTABLE	liable or subject to change or alteration
MUTINY	revolt or rebellion against constituted authority
MYOPIA	a disorder of the eyes where distant objects appear blurred
MYRIAD	a very great or indefinite number of persons or things
MYSTIC	involving otherworldly or symbolic practices or content
NADIR	lowest weakest point
NAPHTHA	naturally-occurring liquid petroleum
NARRATE	to relate a story or series of events by speech or writing
NASAL	of or pertaining to the nose
NASCENT	beginning to exist or develop
NATAL	of or relating to birth
NATTY	smart and fashionable
NAUSEA	a feeling of unwellness, usually with the desire to vomit
NAVAL	of or relating to a navy
NAVEL	the belly button
NEBULA	a cloud in outer space consisting of gas or dust
NECTAR	the juice of a fruit or a blend of fruit juices
NEGATE	to deny the existence, evidence, or truth of
NEMESIS	an archenemy
NEOLOGY	the study or art of neologising (creating new words)
NEONATE	a newborn infant, recently born baby
NESTLE	to settle oneself comfortably and snugly
NETTLE	to sting causing a rash in someone
NETWORK	to interact for the purpose of connections or advancement
NEURAL	of, or relating to the nerves, neurons or the nervous system
NEUTER	to remove sex organs from an animal
NEUTRAL	not taking sides in a conflict such as war, nonaligned
NEXUS	a connection tie or link
NIB	the point of a pen, or either of its divisions
NIBBLE	show some inclination to accept (an offer)
NIL	nothing, zero
NIMBLE	quick and light in movement or action
NIRVANA	a blissful state attained through enlightened experience
NIT	the egg of a louse
NOISOME	offensive disgusting (smell)
NOISY	making a noise, especially a loud sound
NOMAD	any wanderer, itinerant
NOMINA	(in ancient rome) the second name of a citizen
NOMINAL	being such in name only, so-called
NOMINEE	a person named, or designated, by another, to any position
NONPLUS	to perplex or bewilder someone, to confound or flummox
NORM	a standard, model, or pattern
NOSTRUM	a medicine sold with false claims and no demonstrable value
NOTES	a brief record of something written down for memory
NOVEL	new, original, especially in an interesting way
NOVICE	a person who is new to the circumstances, work, etc
NOXIOUS	harmful
NUANCE	a subtle difference or distinction in expression
NUCLEUS	the core, central part (of something)
NUDE	without clothing or other covering of the skin
NULLITY	the state of being void, or invalid
NUNNERY	a place of residence for nuns
NUPTIAL	of or pertaining to wedding and marriage
NURTURE	to nourish or nurse
NUZZLE	to touch someone or something with the nose
OAKEN	made from the wood of the oak tree
OAKUM	a material used to caulk or pack joints
OBELISK	a tapered, stone monolith topped with a pyramidal point
OBESE	extremely overweight
OBLIQUE	neither perpendicular nor parallel to a line or surface
OBLONG	describing something that is longer than it is wide
OBLOQUY	abusively detractive language sharp criticism vituperation
OBSCURE	to darken, make faint etc
OBTAIN	to be established accepted or customary
OBTRUDE	to impose (something) on someone or into some area
OBTUSE	blunt/stupid
OBVERT	to turn so as to show another side
OBVIATE	to anticipate and prevent or eliminate by effective measures
OCCLUDE	to close, shut, or stop up (a passage, opening, etc )
OCCULT	any system claiming use or knowledge of secret forces
OCTAGON	a polygon with eight sides and eight angles
OCTAVE	an interval spanning eight degrees of the diatonic scale
OCTAVO	a book printed on sheets folded to form 8 leaves or 16 pages
OCULAR	of, or relating to the eye, or the sense of sight
OCULIST	an ophthalmologist
ODDITY	an odd or strange thing
ODE	a short poetical composition, a lyric poem
ODIOUS	deserving or causing hatred, hateful, detestable
ODIUM	contempt dislike aversion
ODOR	smell favor reputation
ODOROUS	having a distinctive odor
OFFHAND	without planning or thinking ahead
OGLE	to stare at (someone or something), especially covetously
OGRE	a type of giant from folk tales that eats human flesh
OMINOUS	portending evil or harm, foreboding
ONEROUS	burdensome, oppressive, or troublesome, causing hardship
ONRUSH	a forceful rush or flow forward
ONSET	the beginning or start
ONUS	a legal obligation
OPAQUE	to make, render (more) opaque
OPINION	to have or express as an opinion
OPT	to choose, to select
OPTIC	of, or relating to the eye or to vision
OPTION	something that may be or is chosen, choice
OPULENT	luxuriant, and ostentatiously magnificent
OPUS	a musical composition
ORAL	uttered by the mouth, spoken
ORATE	to speak formally, to give a speech
ORATORY	the art of public speaking, especially in a formal manner
ORDAIN	to invest with ministerial functions or holy orders
ORDEAL	a painful or trying experience
ORDINAL	of a number, indicating position in a sequence
ORGIES	(plural) wild, drunken or licentious festivity or revelry
ORIFICE	a mouth or aperture, as of a tube, pipe, etc, an opening
ORIGIN	something from which anything starts, the source
ORNATE	elaborately ornamented, often to excess
OSSIFY	to convert into or cause to harden like bone
OUD	a musical instrument belonging to the lute family
OUGHT	indicating duty or obligation
OUST	to expel, to remove
OUTCRY	a strong and usually public expression of protest
OUTLAST	to live, last or remain longer than something else
OUTLAW	a fugitive from the law, lawless person
OUTPOST	a military post stationed at a distance from the main army
OUTRAGE	any gross violation of law or decency
OUTRIDE	to ride (a horse, bicycle, etc ) better than (someone)
OVATION	prolonged enthusiastic applause
OVERRUN	to defeat an enemy and invade in great numbers
OVERSEE	to supervise, guide, or direct actions of a person or group
OVERT	open and not secret nor concealed
PACIFIC	calm, peaceful
PACIFY	to bring peace by ending war, violence, anger or agitation
PACT	an agreement, a compact, a covenant
PAEAN	any loud and joyous song, a song of triumph
PAGAN	person or community observing a polytheistic religion
PAGEANT	an elaborate public display, i.e. a parade in costume
PALATE	roof of the mouth sense of taste
PALETTE	a thin board on which a painter lays and mixes colours
PALL	a cloth for spreading over a coffin
PALLID	appearing weak, pale or wan
PALLOR	unusual paleness
PALSY	any atonal muscular condition characterised by tremors
PALTRY	ridiculously or insultingly small
PALUDAL	of or pertaining to marshes
PANACEA	a remedy for all disease or ills, a cure-all
PANACHE	a grand or flamboyant manner
PANDER	to cater to or profit from the weaknesses of others
PANOPLY	a splendid display of something
PAPACY	the office of the pope
PAPYRUS	a tall, aquatic plant native to the nile valley
PARABLE	a short allegorical story that illustrates a moral lesson
PARADOX	seemingly contradictory statement that may be true
PARAGON	a model or pattern of excellence
PARCH	to make extremely, excessively, or completely dry
PARE	to cut off the outer coating, layer or part of
PARIAH	an outcast
PARITY	equality, as in amount, status or character
PARLAY	to bet or gamble on a subsequent race, contest, etc
PARLEY	meeting between enemies under a truce to discuss terms
PARLOR	a room for the reception of visitors to one's home
PARLOUS	perilous, dangerous
PARODY	a satirical imitation of a serious piece of literature
PARRY	to avoid, deflect, or ward off (an attack)
PARSE	to analyse in terms of grammatical constituents
PASSIVE	not reacting to something that should produce an emotion
PATENT	to register an invention with a government agency
PATHOS	the power in forms of expression, evoking pity or compassion
PATRON	a customer, especially a regular one, of a business
PATTER	to make a rapid succession of light taps
PAUCITY	scarcity a lacking of
PAUPER	a person who depends on aid from public welfare funds
PAYEE	one to whom money is payable
PECCANT	guilty of a moral offence
PEDAL	to operate a pedal attached to a wheel in a circular motion
PEDANT	a person who makes an excessive display of learning
PEDDLE	to sell things, especially door to door
PEERAGE	the body of peers of a country or state
PEEVISH	showing annoyance, irritation or bad mood
PENALTY	a punishment imposed for the violation of a law or rule
PENANCE	a punishment undergone in token of penitence for sin
PENDANT	a hanging ornament in jewellery
PENNANT	any relatively long, tapering flag
PENSION	a fixed amount, other than wages, paid at regular intervals
PENSIVE	dreamily or wistfully thoughtful
PENTAD	a group or series of five things
PENURY	extreme poverty
PEON	a lowly person, a peasant who is obliged to do menial work
PERCH	a pole or rod, serving as a roost for birds
PERFIDY	deliberate breach of faith or trust
PERFORM	to do something, to execute
PERIGEE	point in orbit of the moon when it is nearest to the earth
PERIL	exposure to injury, loss or destruction
PERISH	be destroyed decay
PERJURE	to knowingly make a false statement while under oath
PERJURY	the willful giving of false testimony under oath
PERPLEX	to cause to be puzzled or bewildered, confuse mentally
PERSIST	to go on steadfastly and resolutely
PERSONA	a person's perceived or evident personality
PERT	boldly forward in speech or behaviour
PERTAIN	belong as a part have reference
PERTURB	to disturb, to bother or unsettle
PERUSAL	the act of surveying
PERUSE	to examine or consider with care
PERVADE	to become spread through all parts of
PERVERT	to lead astray morally
PEST	destructive thing or a person who is nuisance
PETER	to dwindle, to trail off, to diminish to nothing
PETRIFY	to convert into stone or a stony substance
PETROUS	like a rock hard stony
PHOBIA	an irrational or obsessive fear or anxiety
PHONIC	of or pertaining to speech sound
PICCOLO	an instrument similar to a flute, but smaller
PIED	having patches of two or more colours
PIETY	devout fulfillment of religious obligations
PILFER	to steal in small quantities
PILLAGE	to loot or plunder by force, especially in time of war
PILLORY	a wooden frame with holes for securing the head and hands
PINCERS	a gripping tool with blunt jaws
PINCH	be too tight take between the thumb and finger
PINE	waste away through sorrow or illness
PINION	a bird's wing
PIONEER	a person who is among those who first settle a region
PIOUS	dutiful to parents devoted to religion
PIQUANT	agreeably pungent or sharp in taste or flavour
PIQUE	hurt the pride or self-respect stir (curiosity)
PITEOUS	evoking or deserving pity
PITFALL	covered hole as a trap unsuspected danger
PITH	essential part force soft liquid substance
PITHY	brief, forceful and meaningful in expression
PITIFUL	evoking or deserving pity
PIVOTAL	of great importance (others depend on it)
PLACATE	soothe pacify calm
PLACEBO	a dummy medicine containing no active ingredients
PLACID	calm and quiet, peaceful, tranquil
PLAQUE	flat metal on a wall as a memorial
PLAUDIT	a mark or expression of applause, praise bestowed
PLEA	an appeal, petition, urgent prayer or entreaty
PLEAD	address a court of law as an advocate
PLEBIAN	alternative spelling of plebeian
PLEDGEE	someone who receives a pledge
PLENARY	fully attended, for everyone's attendance
PLIABLE	easily bent
PLIANT	capable of bending, flexible, pliable
PLOD	continue doing smth without resting
PLUCK	pull the feathers off pick (e.g.. flowers)
PLUMAGE	feathers, either covering a bird or used ornamentally
PLUMB	get to the root of
PLUMMET	fall plunge steeply
PLUNGE	move quickly suddenly and with force
PLURAL	consisting of or containing more than one of something
PODIUM	a small platform for a public speaker, a conductor, etc
POESY	the class of literature comprising poems
POETIC	possessing the qualities or charm of poetry
POISE	calm self-assured dignity, especially in social situations
POLAR	of or relating to the north or south pole
POLEMIC	a controversial argument
POLITIC	shrewd or prudent in practical matters
POLLEN	the fertilizing element of flowering plants
POLLUTE	to make foul or unclean
POLYGON	a figure having three or more sides
POMMEL	a knob, as on the hilt of a sword
POMPOUS	affectedly grand, solemn or self-important
PONCHO	large piece of cloth
PONDER	to wonder, to think of deeply
PONTIFF	any high or chief priest
PORTEND	to serve as a warning or omen
PORTENT	an indication or omen of something about to happen
PORTLY	rather heavy or fat
POSEUR	a person who attempts to impress others by assuming a manner
POSIT	to place, put or set
POSSE	a body or force armed with legal authority
POSSESS	to have, to have ownership of
POTABLE	good for drinking without fear of poisoning or disease
POTENCY	strength
POTENT	powerful, mighty
POTION	a drink or draft, especially a magical one
PRATE	to talk much and to little purpose, to babble
PRATTLE	to talk incessantly and in a childish manner, to babble
PRECEDE	to go before, go in front of
PRECEPT	a commandment given as a rule of action or conduct
PRECISE	exact, accurate
PREEMPT	to acquire something (before someone else does)
PREEN	tidy/show self-satisfaction
PREFACE	an introductory part, or preliminary statement
PREFIX	an affix placed before a word to modify a term's meaning
PRELACY	the office of a prelate
PRELATE	a church dignitary
PRELUDE	any action or event that precedes something else
PREMIER	the head of the cabinet in some countries
PREMISE	a proposition supporting or helping to support a conclusion
PRESAGE	foreboding
PRESIDE	to occupy the place of authority or control
PRETEXT	something put forward to conceal a true purpose or object
PREVAIL	to be superior in strength, dominance, influence
PRICKLE	a sharp point
PRIG	a person who is self-righteous and narrow-minded
PRIM	neat formal
PRIMA	most important
PRIMER	a book that provides an introduction to a topic
PRIORY	a monastery or convent governed by a prior or prioress
PRIVITY	a divine mystery, something known only to god
PRIVY	having knowledge of something private or secret
PROBATE	the official proving of a will as authentic
PROBE	to explore, investigate, or question
PROBITY	integrity and uprightness
PROCEED	to go forward or onward, to advance
PROCTOR	to supervise or monitor
PROCURE	to obtain through special means
PRODIGY	a young person having extraordinary talent or ability
PROFANE	irreligious
PROFESS	to make open declaration of, to own or admit freely
PROFFER	to offer for acceptance, to propose to give
PROFUSE	abundant/lavish
PROGENY	offspring or descendants
PROLIX	extended to great, unnecessary or tedious length
PROLONG	to extend in space or length
PRONE	prostrate inclined to (undesirable things)
PROPEL	to cause to move in a certain direction
PROSAIC	commonplace or dull
PROSE	the ordinary form of spoken or written language
PROSODY	the study of speech
PROTEAN	readily assuming different forms or characters
PROTEGE	a person guided and protected by a more prominent person
PROVERB	a basic truth which may be applied to common situations
PROVISO	a conditional provision to an agreement
PROVOKE	make angry vax
PROWESS	skillfulness and manual ability, adroitness or dexterity
PROXY	the power of a person authorized to act in place of another
PRUDENT	wise in practical affairs
PRUDERY	excessive propriety or modesty in speech
PRUDISH	easily shocked excessively modest
PRUNE	dried plum silly person
PRY	get smth inquire too curiously
PUCKER	wrinkle
PUDGY	overweight (pertaining particularly to children), plump
PUERILE	immature, childish
PUNDIT	a learned person, expert or authority
PUNGENT	sharply affecting the organs of taste or smell
PURIST	a person who insists on purity in language, style, etc
PURL	to finish with loops or a looped edging
PURLOIN	to take dishonestly
PURPORT	to convey, imply, or profess outwardly, often falsely
PURVEY	provide supply
PURVIEW	the range of operation, authority, control, etc
PUTRID	rotting, rotten, being in a state of putrefaction
PYRE	a heap of wood or other combustible material
PYX	the small container used to hold the eucharist
QUACK	person dishonestly claiming to smth
QUAFF	drink deeply
QUAIL	lose courage turn frightened
QUAINT	having old-fashioned attractiveness or charm
QUALIFY	to describe something by listing its qualities
QUALM	a sickly feeling of being ill at ease, sudden queasiness
QUARRY	a pit from which stone, slate, etc is obtained
QUARTER	to divide into four parts
QUARTET	a music composition in four parts
QUARTO	a book made up of four leaves, or eight pages
QUASI	resembling or having a likeness to something
QUASI-	1 english
QUAVER	to shake in a trembling manner
QUAY	a landing place for boats along the edge of a body of water
QUEASY	experiencing or causing nausea or uneasiness
QUELL	suppress subdue
QUERY	to ask, inquire
QUIBBLE	to complain or argue in a trivial or petty manner
QUIETUS	a finishing stroke
QUINTET	(music) a composition in five parts
QUIRK	habit or action peculiar to smb or smth
QUITE	wholly
QUORUM	the number of members of something required to do business
RABBLE	mob crowd the lower classes of populace
RABID	irrationally extreme in opinion or practice
RACY	slightly improper or indelicate
RADIATE	to extend, send or spread out from a center
RADICAL	favouring change at the root cause of a matter
RADIX	a number taken as the base of a system of numbers
RAFFISH	low vulgar base tawdry
RAIL	to complain violently (against, about)
RAIMENT	clothing, garments, dress, material
RAMBLE	to move about aimlessly, or on a winding course
RAMIFY	to be divided or subdivided to branch out
RAMOSE	having branches, branching
RAMPANT	violent in action or spirit
RAMPART	a broad elevation used as fortification around a place
RANCID	being rank in taste or smell
RANCOR	bitter, rankling resentment or ill will
RANKLE	to cause irritation or deep bitterness
RANT	to speak or shout at length in an uncontrollable anger
RAPID	describes a process or concept which occurs quickly
RAPINE	the seizure of one's property by force, plunder
RAPPORT	a relationship of mutual trust and respect
RAPT	very interested, involved in something, absorbed
RAPTURE	to experience great happiness or excitement
RAREFY	to make thin to make less dense to purify or refine
RASH	hasty, not careful or considered
RASP	to scrape or abrade with a rough instrument
RATIFY	to confirm by expressing consent
RATION	a fixed allowance of provisions or food
RAUCOUS	harsh
RAVAGE	to devastate or destroy something
RAVE	act with excessive enthusiasm
RAVEL	to pull apart (especially cloth or a seam), unravel
RAVINE	a deep narrow valley in the earth's surface caused by water
RAZE	to demolish, to level to the ground
READILY	promptly
REALISM	a concern for fact and rejection of the impractical
REALM	an abstract sphere of influence, real or imagined
REAPER	a machine for cutting standing grain
REBUFF	snub
REBUILD	to build again
REBUKE	to criticise harshly, to reprove
REBUT	to refute by evidence or argument
RECANT	take back as being FALSE give up
RECAST	cast or fashion anew
RECEDE	to move back, to move away
RECK	to care for, to heed, to regard, consider
RECLAIM	to demand the return or restoration of something as a right
RECLINE	to cause to lean back, to bend back
RECLUSE	a person who lives in seclusion or apart from society
RECOIL	to pull back, especially in disgust, horror or astonishment
RECOUNT	tell someone about something, give an account of an event
RECOUP	to make back, as an investment
RECRUIT	to enlist a person for service in one of the armed forces
RECTIFY	to correct or amend something
RECUR	to occur again
RECURE	to cure, heal
REDEEM	get back by payment compensate
REDOUND	to contribute (to a specified situation or consequence)
REDRESS	to put in order again, to set right, to emend, to revise
REEK	to emanate, as of vapour or perfume
REFER	to direct the attention of
REFEREE	in sports, an authority who governs the rules of the game
REFINE	make or become pure cultural
REFORM	to put into a new and improved form or condition
REFRACT	to change direction from entering a different medium
REFRAIN	to hold back from an impulse to say or do something
REFUGE	a state of safety, protection or shelter
REFUSAL	the act of turning something down
REFUTE	to prove (something) to be false or incorrect
REGAL	of or having to do with royalty
REGALE	to delight or entertain to feast
REGALIA	the decorations or ceremonial clothes of any office or order
REGENT	a person with power to rule in the absence of the sovereign
REGIME	mode of rule or management
REGIMEN	orderly government, system of order, administration
REGNANT	reigning, ruling, currently holding power [from 15th c ]
REGRESS	to move backwards to an earlier stage, to devolve
REIGN	to exercise sovereign power, or to rule as a monarch
REIN	a strap by which a rider or driver controls a horse
REJOIN	to come again into the company of
RELAPSE	fall back again
RELENT	to become less severe or intense, to become less hard
RELIANT	having dependence on
RELIC	a surviving memorial of something from the past
RELISH	liking or enjoyment of the taste of something
REMAND	to send back
REMISS	at fault, failing to fulfill responsibility
REMIT	to forgive, pardon
REMORSE	a feeling of regret or sadness for doing wrong or sinning
REND	to separate into parts with force or sudden violence
RENDER	deliver provide represent
RENEGE	to break a promise or commitment, to go back on one's word
RENOWN	fame, celebrity, wide recognition
REPAST	a meal
REPEAL	to cancel, invalidate, annul
REPEL	refuse to accept/cause dislike
REPINE	at be discontented with
REPLETE	full of
REPLICA	an exact copy
REPOSE	to lay, to set down
REPRESS	to keep under control, or suppress
REPROOF	the act of rebuking
REPROVE	to criticize or correct
REPULSE	to repel or drive back
REPUTE	to attribute or credit something to something, to impute
REQUIEM	any musical service for the repose of the dead
REQUITE	repay give in return
RESCIND	repeal/annul/cancel
RESEAT	to provide (e g a room) with more, or new, seats
RESENT	to express or exhibit displeasure or indignation
RESIDUE	whatever remains after something else has been removed
RESOLVE	to find a solution to (a problem)
RESORT	to frequently visit
RESPITE	an interval of relief from something distressing or trying
RESTIVE	impatient under delay, duress, or control
RETARD	check hinder
RETCH	to make an unsuccessful effort to vomit
RETINUE	a group of servants or attendants
RETORT	to say something sharp or witty in answer to a remark
RETRACE	to go back over
RETRACT	to pull back inside
REUNITE	to unite again, as after separation
REVEL	to make merry, to have a gay, lively time
REVERE	have deep respect for
REVERT	to turn back, or to the contrary, to reverse
REVILE	to attack (someone) with abusive language
REVISAL	the act of revising, a revision
REVISE	to look at again, to reflect on
REVOKE	to cancel or invalidate by withdrawing or reversing
RIBALD	vulgar or indecent in speech, language, etc
RIDDLE	puzzling person or thing
RIDDLED	damaged throughout by numerous perforations or holes
RIFE	widespread (especially of unpleasant or harmful things)
RIFT	an opening made by splitting, cleaving, etc
RIGOR	strictness, severity or harshness
RIPPLET	a small ripple
RISIBLE	causing laughter
RIVET	fix take up secure metal pin
RIVULET	a small brook or stream, a streamlet
ROBUST	strong and healthy
ROGUE	a dishonest, knavish person
ROLL	call calling of names
RONDO	music that returns to a main theme throughout the piece
ROOKERY	a colony of breeding birds or other animals
ROTARY	capable of turning around on an axis
ROTE	routine
ROTUND	having a round or spherical shape, circular, orbicular
ROUT	an overwhelming defeat
ROUTINE	according to established procedure
RUE	to feel sorrow over
RUFFIAN	a tough, lawless person
RUGGED	broken into sharp or irregular points, not smooth
RUMPLE	make rough
RUPTURE	to burst, break through, or split, as under pressure
RUSE	a trick or artifice
RUSTIC	country-styled or pastoral, rural
RUTH	pity or compassion
SACRED	devoted or dedicated to a deity or religious purpose
SAGA	any narrative or legend of heroic exploits
SAGE	a profoundly wise person
SALIENT	prominent or conspicuous
SALINE	containing or resembling salt, salty
SALLOW	having a grayish, yellow-green hue
SALVAGE	to save from shipwreck, fire, etc
SALVE	a medical ointment for healing or relieving wounds and sores
SALVO	a successive charge of artillery, bombs, etc
SANITY	health of mind soundness of judgement
SAPID	tasty, flavoursome or savoury
SAPIENT	possessing wisdom and discernment, wise, learned
SARCASM	harsh or bitter derision or irony
SASH	long strip worn round the waist
SATIATE	satisfy fully
SATIRE	the use of irony,or sarcasm in exposing folly, vice
SATYR	a woodland deity represented as half-man, half-horse
SAVAGE	fierce, ferocious or cruel
SAVANT	a person of profound or extensive learning
SAVOR	taste flavor smth
SAVORY	tasty, attractive to the palate
SAWDUST	tiny bits of wood
SCENT	smell (esp pleasant)
SCHISM	division, especially into mutually opposed parties
SCOFF	to jeer, laugh at with contempt and derision
SCOPE	to perform a cursory investigation, as to scope out
SCORCH	become discolored/dry up/go at high speed
SCORN	to feel or display contempt or disdain for something
SCOTCH	to cut or score
SCOURGE	to punish or criticize somebody severely
SCRIBE	person who made copies of manuscripts before printing
SCRUPLE	a moral standard that inhibits certain actions
SCURVY	a disease caused by a diet lacking in vitamin c
SCUTTLE	to sink a boat deliberately by making openings in the bottom
SCYTHE	a long, curved blade used for cutting grass and grain
SEANCE	meeting where a mystic tries to communicate with the dead
SEAR	to char the surface of something with a hot instrument
SECANT	a straight line that intersects a curve at 2 or more points
SECEDE	to withdraw formally from an alliance
SECLUDE	to shut off or keep apart, as from company, society, etc
SECULAR	material (not spiritual) living outside monasteries
SEDATE	to tranquilize by giving a sedative, to induce sleep
SEDUCE	to entice someone to engage in a sexual relationship
SEER	a person who prophesies future events
SEETHE	to be in a state of agitation or excitement
SEIZE	to deliberately take hold of, to grab or capture
SEMINAL	having possibilities of future development
SEMINAR	a small group of students engaged in study
SENILE	decline in mental or physical health due to old age
SENSORY	pertaining to the senses
SENSUAL	inducing pleasurable and/or erotic sensations
SEQUENT	that comes after in time or order, subsequent
SERE	make hard and without feeling
SERENE	calm, peaceful, tranquil
SERMON	reproving a person for his faults
SERVILE	like a slave lacking independence
SEVER	break off
SEXTET	any group or set of six
SHACKLE	a ring of iron used to secure the wrist or ankle
SHALLOW	little depth not earnest
SHARD	piece of broken earthenware
SHEATH	cover for the blade of a weapon or a tool
SHEER	transparently thin
SHOAL	a place where a body of water is shallow
SHREWD	astute showing sound judgement
SHRIEK	to utter a loud, sharp, shrill sound or cry
SHRILL	sharp piercing
SHRIVEL	to collapse inward, to crumble
SHROUD	a cloth in which a corpse is wrapped for burial
SHUN	keep away from avoid
SHUNT	send from one track to another lay aside evade discussion
SIC	written parenthetically to show something quoted verbatim
SIEGE	to attack a fortified place to isolate it from help
SIMILE	figure of speech in which 2 unlike things are compared
SIMPER	(give a) silly/self-conscious smile
SINGE	to burn slightly
SINUOUS	having many curves, bends or turns
SINUS	a cavity in any organ or tissue, i.e. the nasal passage
SIROCCO	a hot, dry wind blowing from N. Africa into southern Europe
SKEPTIC	a person who questions the validity of something
SKIFF	a small flat-bottomed open boat
SKIT	short piece of humorous writing
SKULK	to move in a stealthy manner
SLACK	sluggish dull not tight
SLAKE	to allay thirst, desire, etc, by satisfying it
SLANDER	defamation
SLATE	king of blue-grey stone propose criticize
SLEAZY	marked by low quality, inferior, inadequate
SLEIGHT	cunning, craft, artful practice
SLIGHT	very small in size, degree, amount, or importance
SLOTH	laziness, slowness in the mindset
SLOUGH	to shed (skin)
SLUR	join sounds/words (indistinct)
SMELT	to fuse or melt ore in order to separate the metal contained
SMOLDER	burn slowly without flame
SMUG	irritatingly pleased with oneself, self-satisfied
SNARE	trap
SNIDE	derogatory in a nasty, insinuating manner
SNUB	treat with contempt
SOAR	rise fly high
SOBER	self-controlled
SODDEN	soaked saturated
SOGGY	heavy with water
SOJOURN	to reside somewhere temporarily
SOL	the fifth step in the solfège scale of c
SOLACE	comfort in sorrow, misfortune or trouble
SOLDER	an alloy applied between metal objects to unite them
SOLEMN	deeply serious and somber
SOLICIT	to persistently try to get something or bring about an event
SOLUBLE	capable of being dissolved or liquefied
SOLVENT	a substance that dissolves another to form a solution
SOMATIC	of the body
SOMBER	dark and dull in colour or things in respect to colour
SONATA	musical piece for 1 or more instruments in 3-4 movements
SONNET	a fixed verse form of 14 lines usually in iambic pentameter
SOOT	black powder in smoke
SOPHISM	any false argument
SOPRANO	the highest singing voice in women and boys
SORCERY	magic done with the help of evil spirits
SORDID	dirty or squalid
SPARSE	having widely spaced intervals
SPARTAN	austere, frugal or characterized by self-denial
SPATE	a sudden outpouring
SPAWN	to produce or deposit (eggs) in water
SPEAR	weapon with a metal point on a long shaft
SPECTER	a ghostly apparition
SPINOUS	thorny, as a plant
SPLICE	join (two ends)
SPONGE	porous rubber for washing live at once expense
SPURN	have nothing to do reject or refuse
SQUALID	foul and repulsive from lack of care or cleanliness
SQUALOR	filth and misery
SQUAT	crouch/settle without permission
STAGY	theatrical
STAID	of settled or sedate character, not flighty
STAMINA	the energy for continuing to do something for a long time
STANCH	to stop the flow of
STANZA	a unit of a poem, equivalent to a verse
STARK	sheer, utter, downright or complete
STATELY	of people: regal, dignified, worthy of respect
STATIC	characterised by a fixed or stationary position
STATICS	branch of mechanics dealing w/ forces in static equilibrium
STATURE	a person or animal's natural height when standing upright
STATUTE	written law, as laid down by the legislature
STAUNCH	to stop the flow of (blood)
STEALTH	secret or clandestine procedure
STEEPLY	rising or falling sharply
STELLAR	of, pertaining to, or characteristic of stars
STEPPE	the grasslands of eastern europe and asia
STIFLE	to quell, crush or end by force
STIGMA	a mark of disgrace or infamy
STING	smth sharp
STINGY	reluctant to give or spend
STINT	a period of time spent doing something
STIPEND	a fixed payment, generally small
STIPPLE	paint with dots
STOIC	unaffected, indifferent, restrained
STOKE	to stir up and feed, especially, a fire or furnace
STOLID	showing no emotion impassive
STRAIT	a narrow passage of water connecting 2 large bodies of water
STRATUM	one of several parallel horizontal layers of materia
STRAY	wander lose one's way
STREAK	long thin move very fast
STRIDE	walk with long steps
STRUT	a supporting bar
STUPEFY	to dull capacity to think, thereby reducing responsiveness
STUPOR	a state of reduced consciousness or sensibility
STYGIAN	hence dark gloomy
STYMIE	to hinder obstruct or block
SUASION	the act of urging or influencing, persuasion
SUAVE	charming, confident and elegant
SUBACID	somewhat acidic
SUBDUE	overcome bring under control
SUBLIME	elevated or lofty in thought
SUBORN	induce by bribery or smth to commit perjury
SUBSIDE	to sink or fall to the bottom, to settle, as lees
SUBSIST	to survive on a minimum of resources
SUBSUME	include under a rule
SUBTEND	to extend or stretch underneath or opposite something
SUBTEXT	the underlying or implicit meaning
SUBTLE	fine or delicate in meaning or intent
SUBVERT	to overturn from the foundation, to overthrow
SUCCOR	assistance relief in time of distress
SUCCUMB	to yield to an overpowering force or overwhelming desire
SUFFICE	be enough
SUFFUSE	to spread through or over something, especially as a liquid
SULLIED	to be stained or discredited
SULLY	to soil, stain or tarnish
SUNDER	to separate
SUNDRY	various miscellaneous separate
SUPINE	lying on the back slow to act passive
SUPPLE	bending readily without breaking or becoming deformed
SURETY	security against loss or damage, guarantee
SURFEIT	an excessive amount of something
SURLY	lordly, arrogant, supercilious
SURMISE	a conclusion drawn on limited evidence or intuitive feeling
SURPASS	exceed; be greater than
SUSPECT	to suppose (something) to be true without evidence
SVELTE	attractively thin, gracefully slender
SWARTHY	tawny, dusky, dark
SWATHE	to bind with a swathe, band, bandage, or rollers
SWERVE	change direction suddenly
SYLPH	a wood nymph
SYLVAN	pertaining to the forest, or woodlands
SYNERGY	elements that make an effect greater than the sum of parts
SYNOD	an ecclesiastic council to consult on church matters
SYNONYM	a word having the same meaning as another in the language
SYNTAX	a system or orderly arrangement
TABLEAU	a picturesque grouping of persons or objects
TACIT	done or made in silence, implied, but not expressed
TACK	a short nail with a flat, broad head
TACT	a keen sense of what to say or do to avoid giving offence
TACTICS	the art of implementing means to achieve immediate goals
TACTILE	tangible
TADPOLE	form of a frog when it leaves the egg
TALON	claw of a bird of prey
TAMP	tap or drive down by repeated light blows
TAMPER	interfere with
TANGENT	touching a curve at a single point but not crossing it
TANNERY	a place where people tan hides to make leather
TARDY	late, overdue or delayed
TARNISH	to oxidize or discolor due to oxidation
TASSEL	bunch of threads
TAUNT	contemptuous reproach hurtful remark
TAUT	tight, under tension, as in a rope or bow string
TAWDRY	cheap gaudy showy tacky
TECHNIC	technique
TEDIOUS	boring, monotonous, time consuming, wearisome
TEDIUM	the quality or state of being wearisome
TEEM	to be stocked to overflowing
TEMPER	to moderate or control
TEMPT	to entice to do something often regarded as unwise or wrong
TEMPTER	someone or something that tempts, especially to evil
TENABLE	capable of being maintained or justified, well-founded
TENANT	a person that rents or occupies land
TENET	any principle held as true by members of a group
TENOR	the adult male voice between the bass and countertenor
TENUOUS	insubstantial flimsy weak
TENURE	the holding or possessing of something
TEPID	lukewarm
TERRIFY	to frighten greatly, to fill with terror
TERSE	brief and to the point
TESTY	easily annoyed, irritable
TETHER	a rope or chain by which an animal is tied to a fixed object
THEISM	belief in the existence of at least one deity
THERMAL	pertaining to heat or temperature
THESIS	a subject for a composition or essay
THRALL	a person who is enslaved by some power
THRIFT	care economy thriving prosperous
THRIVE	prosper; flourish
THRONG	a crowd
THWART	obstruct/frustrate
TILTH	the act of tilling land for crop
TIMBRE	the quality of a sound independent of its pitch and volume
TIMID	shy easily frightened
TINGE	to colour slightly
TIPSY	foolish as a result of drinking alcoholic beverages
TIRADE	a long, angry or violent speech, a diatribe
TITTER	to laugh or giggle in a somewhat subdued manner
TOADY	a flatterer
TOME	a very heavy or learned book
TONIC	smth giving strength or energy
TOPPLE	be unsteady and overturn
TORMENT	severe pain or suffering
TORPID	sleeping sluggish lethargic dormant
TORPOR	sluggish activity, inertia
TORQUE	twisting force causing rotation
TORRID	very hot and dry
TOTTER	to walk, move or stand unsteadily or falteringly
TOUT	person who worries others to buy smth to use his service
TRADUCE	to slander, or to speak maliciously and falsely of
TRAIT	an identifying characteristic, habit or trend
TRAMMEL	a restraint
TRAVAIL	toil, painfully difficult work
TREBLE	a high or shrill voice or sound
TREBLY	having treble, or high-pitched, qualities
TREMOR	to shake or quiver excessively and rapidly or involuntarily
TRESTLE	a frame with a horizontal beam supported by a pair of legs
TRIAD	a grouping of three
TRIBUNE	a person who upholds or defends the rights of the people
TRICKLE	flow in drops
TRIDENT	a three-pronged spear somewhat resembling a pitchfork
TRINITY	a group of three people or things
TRINKET	a small showy ornament or piece of jewelry
TRIPOD	a three-legged stand or support, as for a camera
TRISECT	to cut into three pieces
TRITE	lacking in originality, stale
TRIVIAL	of little significance or value
TROUGH	a long box used to hold food and water for animals
TRUANT	a student who stays away from school without permission
TRUCE	(agreement) stop of fighting for a time
TRUCKLE	to submit or yield tamely
TRUDGE	walk heavily
TRUISM	a self-evident or obvious truth
TRYST	an arrangement between lovers to meet
TUMULT	violent and noisy commotion of a crowd or mob
TURBID	muddy having the sediment stirred up
TURGID	excessively ornate swollen or bloated
TURMOIL	a state of great commotion, confusion or disturbance
TUTELAR	serving as a guardian, protective, tutelary
TWINGE	a sudden, sharp pain
TYPICAL	capturing the overall sense of a thing
TYPIFY	to embody, exemplify, to represent by an image
TYRANNY	arbitrary or unrestrained exercise of power
TYRO	a learner or beginner
UMBRAGE	offense resentment
UMLAUT	a mark over a vowel used to indicate a different vowel sound
UNCANNY	extraordinary
UNCOUTH	rough awkward
UNCTION	anointing, as a medical treatment or religious rite
UNDULY	excessively
UNEARTH	discover and bring to light
UNFROCK	to remove from status as a member of a clergy
UNGUENT	therapeutic skin cream with medicinal ingredients
UNIFORM	identical or consistent
UNIFY	to become one, merge, combine
UNKEMPT	dishevelled, untidy, dirty, not kept up
UNRAVEL	to separate the threads (of)
UNYOKE	to release something from a yoke or harness
UP-KEEP	the process of properly maintaining something
UPBRAID	scold reproach
UPCAST	to cast or throw up, to turn upward
UPHEAVE	to heave or lift up, raise up or aloft
UPRIGHT	vertical, erect
UPROOT	to tear away from a native place or environment
UPSHOT	the final issue, conclusion or result
UPSTART	to rise suddenly, to spring
UPTURN	to turn (something) up or over
URBAN	related to the (or any) city
URBANE	courteous, polite, refined, and suave
URCHIN	a mischievous child
URGENCY	imperativeness
USAGE	a customary way of doing something
USUALLY	most of the time
USURP	to seize power from another, usually by illegitimate means
USURY	the practice of lending money at an exorbitant interest
UTILITY	the state or condition of being useful, usefulness
UTMOST	of the greatest or highest degree, quantity or the like
UTOPIA	an ideal place or state
VACATE	to move out of a dwelling, either by choice or by eviction
VACUITY	absent of thought or intelligence
VACUOUS	empty, without contents
VACUUM	a space entirely devoid of matter
VAGARY	an erratic notion or action
VAGRANT	a person who wanders and has no permanent home or employment
VAIN	without use result conceited
VALE	valley
VALIANT	boldly courageous
VALID	well grounded or justifiable, pertinent
VANTAGE	a position affording some advantage or commanding view
VAPID	lacking or having lost life, sharpness or flavour
VARIANT	tending to change or alter
VASSAL	a person granted land in exchange for loyalty to a superior
VEER	change direction
VEGETAL	pertaining to vegetables or other plants
VEILED	covered or concealed by a veil
VELVETY	like velvet (but not velvet), soft, smooth
VENAL	ready to do smth dishonest
VENDOR	a person or a company that vends or sells
VENEER	a thin layer of wood
VENIAL	able to be forgiven or pardoned
VENISON	the meat of a deer
VENOM	poisonous fluid that animals secrete by biting or stinging
VENOUS	of or pertaining to veins
VENTURE	to undertake a risky or daring journey
VERBOSE	characterised by the use of many or too many words
VERDANT	covered with growing plants or moss
VERIFY	to substantiate or prove the truth of something
VERITY	truth, fact or reality
VERMIN	small animals or insects that harm people, property, crops
VERNAL	of or pertaining to spring
VERTEX	the highest point of something
VERTIGO	a dizzying sensation of tilting within stable surroundings
VERVE	spirit vigor enthusiasm
VESTIGE	a mark or trace of something no longer in evidence
VETO	the power to reject bills passed by the legislature
VEX	annoy distress trouble
VIABLE	able to live on its own (as for a newborn)
VICEROY	one who governs a place as the representative of a monarch
VIE	to contend for superiority
VIGOUR	energy: forceful exertion
VILIFY	slander say evil things
VINERY	vineyard
VIOL	a bowed instrument common in the 16th and 17th centuries
VIOLA	stringed instrument of the violin family, larger than violin
VIPER	a poisonous snake in the family viperidae
VIRAGO	a loud domineering woman a scold or nag
VIRILE	being manly
VIRTU	knowledge of the fine arts
VIRTUAL	imitated, simulated
VISAGE	countenance, appearance, one's face
VISCID	sticky
VISCOUS	sticky, thick as a fluid
VISTA	a distant view seen through some opening
VITAL	relating to, or characteristic of life
VITIATE	lower the quality weaken the strength
VITRIOL	something highly caustic or severe in effect, as criticism
VIVIFY	to bring to life
VOCABLE	able to be uttered
VOGUE	something in fashion at a particular time
VOLANT	having extended wings as if flying
VOLUBLE	characterised by a ready and continuous flow of words
VORTEX	a whirlwind, moving matter in the form of a spiral
VOTARY	a person bound by solemn religious vows, as a monk or nun
VOTIVE	dedicated or given in fulfillment of a vow or pledge
WAFFLE	talk vaguely and without much result
WAFT	scent waving movement carry lightly through
WAG	merry person
WAGGISH	roguish in merriment and good humor
WAIF	a person, especially a child, who has no home or friends
WAIVE	to refrain from claiming or insisting on
WALLOW	to move lazily or heavily
WAMPUM	formerly native american peoples' currency
WANE	to decrease in strength, intensity, etc
WANTON	deliberate and without motive or provocation
WARILY	in a careful manner
WARLIKE	hostile and belligerent
WARP	to bend or twist out of shape
WARRANT	authority written order guarantee
WARY	watchful, being on one's guard against danger
WASTREL	one who wastes time or resources extravagantly
WAVELET	a small wave, ripple
WAVER	to sway back and forth, to totter or reel
WAYLAY	to lie in wait for and attack from ambush
WEAL	well-being, prosperity or happiness
WEAN	to accustom a child to food other than mother's milk
WEE	little, very small
WEIGH	measure hoe heavy smth is
WEIGHTY	having weight, heavy, ponderous, as, a weighty body
WELTER	to roll, toss or heave
WEND	to go proceed
WHEEDLE	to influence a person by smooth, flattering words or acts
WHELP	to give birth
WHET	to sharpen by grinding or friction
WHIM	a fanciful impulse, or whimsical idea
WHINE	to utter a complaining cry or sound
WHOLLY	entirely
WIELD	to command, rule over, to possess or own
WILE	a trick, artifice or stratagem meant to fool, trap or entice
WILLFUL	deliberate, voluntary or intentional
WILY	sly, cunning, full of tricks
WINCE	show bodily or mental pain
WINNOW	to remove lighter particles from grain
WINSOME	sweetly or innocently charming
WINTRY	suggestive or characteristic of winter, cold, stormy
WIRY	thin, muscular and flexible
WISPY	like a slender, flexible strand or bundle
WISTFUL	full of yearning or longing
WITHER	to shrivel
WITLING	a person who feigns wit, pretending or aspiring to be witty
WITTY	amusingly clever in perception and expression
WIZEN	to become wrinkled by shrinkage as from age or illness
WIZENED	withered, shriveled
WOO	try to win
WRAITH	a ghost or specter
WRANGLE	to bicker, or quarrel angrily and noisily
WRATH	strong or fierce anger
WREAK	to inflict, especially if causing harm or injury
WRENCH	to twist suddenly and forcibly
WREST	to pull or twist violently
WRIT	written order
WRITHE	to twist or turn so as to distort, to wring
WRY	produced by a lopsidedness of the facial features
YARN	tale story fibers for knitting
YEARN	to have earnest or strong desire
YOKE	a device for joining together a pair of draft animals
ZANY	ludicrously or incongruously comical
ZEAL	eager desire or endeavor
ZEALOT	a fanatic
ZEALOUS	ardently devoted or diligent
ZENITH	a highest point or state
ZEPHYR	a gentle, mild breeze
ZODIAC	an astrological system